o-------------------------------------------------------------------------------------------------------------------------------------------------------------------------------------------------------
E------------------------------------------------------------------------------------------------------------------------------------------------------------------------------------------------------T
|------------------------------------------------------------------------------------------------------------------------------------------------------------------------------------------------------B
M------------------------------------------------------------------------------------------------------------------------------------------------------------------------------------------------------?
-------------------------------------------------------------------------------------------------------------------------------------------------------------------------------------------------------?
Eoo-o---?oo--------oXo--o-o?-?---oBoo-X-----o---M----X-o-----------X------o----Bo?-o-?o-X----o-o-B-----oMoo--oB-----------X-----oooXoo--o----o----?--o----?--M-o-o---oBXo---B?-M-----M-??oo?--ooo-?----|
o---o------oo-X-oB-o---Mo-E------o-----o-------o---o----o---?-------------------o--M--o-----o-----o--oo-----B-o-oB--o---Mo-oo-oo---oo----X--o--oo--o-o------oo---Mo--------o-oXo-----o---o----o-oo---M-M
Xo-?M---o-----Xo--o---o-o-?---oo----o-o--B-B-X---------o-Mo-ooo-----oo-E-o--o---Mo---E-----------ooM--------------B-oo-o-?oo--------o-----o--o-o--o----------------o-o-----ooMo--X-o-o-o--o?B---o------v
|----o-o-M--?o----o-X-oooo---oB-M-M-B--------ooB--o--M--o--?M-----o?-BBXX-B-------o-o?---?---o-o--oo----o--o----oo---o--?---o-----oo?--o--o-o-o-X--o-oo-Mo---oo-B---?oo?---o-------o---o----o-oo-o--oMoE
-?---?-M----ooo--ooXo----?---Bo---o-----------X--------oM----o-o------o-X-----M-----------------o---X----o-o-o--o-----o--o--------o--o-o--o---o--------oo----MB--o------o-?oo-------o--oo--oo--o-o---oXE
B-o-o----oo-M-------?-Eo----X-o---o-M---o--o-----oo---M-------o---o----MX------o-M-o------------oMo--?------o-o-------o----o-oo---------oo----o-X------o--o---------o--o-------oE-X-XM--?-o--o---------o
M-o----?--oo--oo----MBMM-oM--?----?oo----E-----o--------o----o----XX-------oooM-o---X-------ooo----o-o---X-oXo-o------Xo--M-o--oooo--o-------------oo-oo-?-----o--B----o--o-o-MM?M-?o-o?oB----o-------o|
E-----Bo-M---Bo-oooMo-----------o--oo--o?-----MB--o----X---o--o--o--B---MMo-o--o--o--o-------BM---?--?---Xo---o---o-----oo----?XX-o----oX---Bo---------oo--o------------?--------------------Mo-o-----ME
----o-------------o------------o---------oo-----o-----------o-o------------------------------o---oooo----------oo-o------ooo-------o-oo---Xo--o-o-ooo---------o---o---------oo--------ooo--o-----o------
X----X-----o--o---o-o--o---oo-o-o-o--Xo--oo---------------------oo--o--o-o--oo-o-o--o-o-o---o-------o----oo-o-o--o----oo---------o-oo-o-o----o----o-----o-o-o--o---------o-oo------o-o--oo----o-oo-----X
XXXXXXXXXXXXXXXXXXXXXXXXXXXXXXXXXXXXXXXXXXXXXXXXXXXXXXXXXXXXXXXXXXXXXXXXXXXXXXXXXXXXXXXXXXXXXXXXXXXXXXXXXXXXXXXXXXXXXXXXXXXXXXXXXXXXXXXXXXXXXXXXXXXXXXXXXXXXXXXXXXXXXXXXXXXXXXXXXXXXXXXXXXXXXXXXXXXXXXXX
