?-------------------------------------------------------------------------------------------------------------------------------------------------------------------------------------------------------
?------------------------------------------------------------------------------------------------------------------------------------------------------------------------------------------------------?
X------------------------------------------------------------------------------------------------------------------------------------------------------------------------------------------------------|
X------------------------------------------------------------------------------------------------------------------------------------------------------------------------------------------------------X
E-------------------------------------------------------------------------------------------------------------------------------------------------------------------------------------------------------
E-X--XE?oME?MXo-oo-X?EEo-?XoooXo?M?Mo--o-Xo?--Mo--?XMX-?E?MXEB--EMEMB-E-EMXBBBX-----E?---BM-EBoB---B?-BE?MoXMBMoEXMo?X-XXEXo-XBoE-oX-E-o--X-MEM-BXBM--M-oX?-E-M-X-M-BMoEEXoooo?XoXEXoo-M?o-oo-EoMMoB-B-o
TMMBM--?BXMBEo-XB-?-??X?-BoBBB??----oEEXM-o---MXB--EMX---ooBoM-MBBo?--E-??oo---o-B-B?Moo?X?-o-o-o--oEoB--oMEXEEo-EoE-----o-Mo-oB?XooM--X-BMM?XXEoME-E?-o---?oE-Mo-BBE--o?M---BM-o?XMEo?-M--EX-M--E-Xo--?
--o-XEo--o-?oo?BoXo??E-?-?MoXEMME--B-?X--Bo--BBB?EX?MMBEB?E-?E?---?MXM-XXXoXEMB------Moo--o-o-MEE-E-XMX-X??BBEXBM--EM?----B?M-X-MBB--oo?o-?B-o-M?E--BMB?oMoX--EXB??B-MMX-BE-E?oX------XoX-oM??BoEMXMoB-v
?B-BEXMBB-BX-XooXo--oooMMo-EoB-oXX---BMBoB-BX-Mo???MXXE-EB-??--MEooMEMB-?E-M?X?o-ooM-o-oMB-XBM?BoMB---BEEoo---BBBo---BX-o-Bo?Booo-Eo-X--o---?-X-EMB?MM--?-oBEM----XoEX-MEM-oB-X-oEBMBB-?-BBX-?X-B-ME-XX-
|ooBEEM-MEMMo?Boo--M?-oM?--BMXB-?-B-B?o?EoE----XM?-oo-?-E-B--EBEo?-?o-oBBooX-?MXo-MXXXBM-oX?-E?-o?M-Mo--oEE?ooo-ooM-o-?BEXX-oB-EX-o-o-E?oE-X-EooBB-??-EBB?-M-EoB-X----XM-MooB---?MMXoB-BoE?M?-E---?BMB-M
EB--oBBX-X-BM?---EXoM---BB-?XoB-Xo-X---XE-XEX--M-o-E-B?-E?-BMBEX-XoMX?oEB-XooooME-oEBXXM-B-MX-?XoXo---?Bo-XEXoEXB-o-?E---MB?Xo?X----B-XX-XM-E?EXX-o-?M?BX--BMEEo-EMMEo-M-?EB-Boo-ME-B-?MoBEXME--?E-EX-B-
?--X-BBXEMo----?-ooBoXMoo-?-MBBE-MB??-oBEMBB?oM?XE-E-BBBEEBEE?BM?E----?MME-EMoBMo?MX--?B-B---EoM-BXMXXEMoEEEEoX--ME?B--?EEE-X-?--oX-XXo-B-MBXB--B-----M--oEXBE-o-oXMoooo-BE-EEXXMMMooME-o-M--EX-BBo-BMXB
MXB-?oBB-oM-EooB-XX-oXXEBE?Xoo-B--Bo-BEXooMB---o-?oooo-oB-X???o-?M-oBoo-BoBoXM--BMXBE?oXEXBMM?o-Xo-ME--XB-?M?X-BoMoMo?-Xo-M?MooM?-oMXEoooEEMX?B-----Mo?BEEo?-X-?oMB-BBE-?o-XoX-Xo?MXX-EB-MBMEEBXM--BEBEo
X--oEBB-E--?oX?X-X-B-B-XBXBBX--XX-oooooXoXXB-o-EBo---BB?oB?ooXo-XB-?--oo?o--oB-X-X---B?XXX-Bo--o-EEo-ooo-oE----oX-Bo?E?---o----XoEBB-B--oEEBBB-X-??-X?EXB----EBo---o--???---BBX-?EoXoBo--?Bo?---Bo-Xo---
m-E?-oE-B?X?BEXoo?----?-?X-Bo--?--?oXB----BX--B?X-oEo---EE-B-BoB--oE-----XE--oo---XX-XXBB--?-o-E--B--?X-?-----X-?X??----Bo-o---B?-X-EX-E---o-??oEBXX-oB-oB-BE--EoXoEX-X-X---?B-?--o--X-oo?X-E??B--B?-BoT
XXXXXXXXXXXXXXXXXXXXXXXXXXXXXXXXXXXXXXXXXXXXXXXXXXXXXXXXXXXXXXXXXXXXXXXXXXXXXXXXXXXXXXXXXXXXXXXXXXXXXXXXXXXXXXXXXXXXXXXXXXXXXXXXXXXXXXXXXXXXXXXXXXXXXXXXXXXXXXXXXXXXXXXXXXXXXXXXXXXXXXXXXXXXXXXXXXXXXXXX
