--------------------------------------------------------------------------------------------------------------------------------------------------------------------------------------------------------
--------------------------------------------------------------------------------------------------------------------------------------------------------------------------------------------------------
--------------------------------------------------------------------------------------------------------------------------------------------------------------------------------------------------------
--------------------------------------------------------------------------------------------------------------------------------------------------------------------------------------------------------
--------------------------------------------------------------------------------------------------------------------------------------------------------------------------------------------------------
--XMBMBT--B?XMBXX-??M----?MX-M?---MB-MM---X--X---M-?M----?-BX------TM-o------?X?-----MMMo---B-------X---?----X----?M?B-X--BM-XXM-B--?BX-MM-M?-EM-----M-?---MB-XB---XoB-MM--?X---B-oMBBB--B-o-M----X-----
-------|-X----oX-?o----??--?---oB-o-B-o?-M--M--X--Xo-MXM--M--MM--?-|--?----?------X----oX-?-o-XB?oM-?B--oB--X-MXX--o-oB?B--oXX--?-X-ooB--oXoMMX-TBM-B---?-X-------XMM-Mo-B?oB?----B--o-BB-MXMoo?M--B----
-B--?M-X?MMXE--BM-?---?---M--XM---?--?-oo---oBM--X----M-X--MB--?--?X-----M?-?-----M-XM--M--BM----oo-----------o--B-?-----o-X-X-Mo------X-?X-----|----Xo-o--M-?----X--?---o-X---B------?------BXo----?XMv
--??ooB-----XB--o--B--o-o-----oXX----o--?----o------?-o-BX-o--?o-?-M-X-M---X-------M---?--X-----o--X--Xo--B--BXoM-------?MXBM?--?-M-----?-oXo--?X--o--B-----M-E--XX-----B--X?B-o?-MX?---?--BB-o--MX-o--f
----MX----oB-o------X-M---?-----??-?------B-----??B----X--M-----o----?-oB--B-BM-oM----Mo-?-?B---?-??M--M----M--M-X--?-o----------B--?--X--BX-----oBXX--oB--X?MMMMoo--BXMo?-Mo-?X---o-M----o-------E--?-f
---Bo---X---BB-Bo-?-T--X?M-X--?X--?-o------X----o------------M--------XM--?-o--BX-XB---Xo----?X---o---M-M--B--X---X---X--B----------oX?--X-Bo?-MBB?M-B-------o---B-------oX--X-X--MM---MB-BXM-o-MBX-?--f
---o-oXMB----o--BM--|X----oBBBo-X-o?X------MXoBo----?M--XM-----XBM-?--?--?--?-----o-BE--?Mo?B--?-?X-----o----------??XB?M-o-oB---X?MX---?-?o--o-o--------B--MM---------X-MB----E----?----X-o--?X--o----f
-?-X?X----?-MM-B----X?---?B----X?-o--M-------?-----?-----o-X?X-M--X--B---o-Xo-X-B-BMMXM---B---X---E--X-BM--X?-?-oo?----o---MX--B-X-oEo---M----XX--EB--??M-----?-?--X--B----X---XM?---M--M--M---XE-X-X-Bf
-o--o---o-oX-o-oXX--X---------E---X---X--X-----o-X-oT---ooo---o-o-T---X---------oo----X-----X-E-oo---------E-------o--o--Eo---------X--X--X--X--MXX-----oX----o-----o--------X-----T----o---XX--B-X----f
m---XX-o-XX----X-X---------o-BM--o-----oX---oX------|-oBX-oX-X----|----------o---X-X--X------oB---o--o---XB?X------------X-----------X--------X--oo------X--------X--------o-------|---------X---------X
XXX--XX--X-XXX-XX-XX--XXX-XX--XX--XXX-X-X-XXXX--X--XXX--X--XX-XX--X-XX-XX-X-XXXXXX-X--XXXX-X--XX--X-XXXX-X--XXXXXXXXXXXXX-X--XXX-X-X-XX-X--XXXXXXX-XXXXXX--X--XXXXX-XXXX--XX--XXXX-X--XXXX-X-X--X--XXXXX
