?------------------------------------------------------------------------------------------------------------------------------------------------------------------------------------------------------T
X------------------------------------------------------------------------------------------------------------------------------------------------------------------------------------------------------E
X-------------------------------------------------------------------------------------------------------------------------------------------------------------------------------------------------------
X------------------------------------------------------------------------------------------------------------------------------------------------------------------------------------------------------B
o------------------------------------------------------------------------------------------------------------------------------------------------------------------------------------------------------E
T|-oMBo??-MB-XXB-?M----oo-Mo-E-o?MBo-o--MM?oo-ooXX-oB-oXo?o--BXMo--o-X-X-BX-o-?-Boo-X?M?XX-o---?B?--X-oBB-MXMooo?B-BMX-o---oXoo--o-Bo-EMMooMX?o?-MB--ooXM?oEM?-M--oX-XXXM?-BBM--XM?M-B-??oXX-oBM-MB-XE-M
oX-o--B--M--X-?-B---o?oM-M-XBM?-----o-X?---X-?XMo??M-oB---X-o-M-MoBB-o--E-o-M----?ToM----oEMoM----oX?Mo------BMo--B---XX|o-o-?BoMX--BBX--M--M------?-BM---X?----BX--?-oo--------o---------B-oE--o---??BB
--Mo-E-oB-oX?B---o-MB-B-?--X-E-M-X-oM----|-oX-B-?---oB-o-o-Bo-------XMBMXXXo--o?--|M-?XB-?M-o--|--BM----X-?-?--B-BXMM-MMXBoM---o-BX?BB-------B---X------MBMM-BME-o-M-?--o-o--XB-----X-BBME-oBMXoMoX?T--v
MB-XXM-??M----o-BMM----B-MMBXX--M--B---XXXXB-B----X?o-BB?B--XoX-X------XMM?X-BE-MMX-X-o-M--XMMMX-?----E-XB-?--B-M?XXo---?-o-Bo-o--o----?--XM-----oo-?X-M---XX-X???E-B--oB-o----M??XBM?--?MXXoX-B-o--|--?
----oMB---|--oX-----Bo-------ooX-----o--M-M-M-o-o-M-MX----M-----oMooXBE--ME--M?----oo--------------BEX?-M-M-o-----BXBB-o--Mo-B-X--oX------E-?oB?M-?o--o---o-M---BXXX--M---B-X-o---E---MX--M--oB-M?-oX--o
-M-B----o-X--MB--M-X-MEB--B--MXB----?-BB-o----BMX--?-o------M?--X-?MoBXXXMMX--?B--M--XoX--XMo--Eo-M?BBXB-B-B-B--oX-B--X?--------M--B--oo?M?X-M---E----B-oMXM-o-B--X--?-o-o-B--??MBX-BX-B-----M-----M-B-T
X---B-M-?B-----XE--BBM?--X-B?-X--Xoo-o---?-MEB-?-BX--B----B---o??X---Mo----MM----M-?o-Mo?-X-oBX??-?o?-X-----X-o-M---X---M-MXB?oo--o--X?-ME-BX-EMBXX-Xo----?-M----B-?--o-XM-------BXX--?--oX-?-o--M--o-B-
?-?----B-----o-MXMB--XB-E?B?BBX?---E-o-B--B-B---------?BM--|?----?----X-ooX----M----E--X---??------B-----oo--o-M--?B--X--B----oB-??M---oBBB-M|XXo-|-oB-oX--B-B-?--o-Mo?-X-?---?---?TM----MBB-X----M--o-o
|--??-o--B--o?X-o--B-?-?X--o--o---oX--B-Bo--XE--oXoo-------|-BoBB--oo-?-XX-B-----oX-?--B--------o---?BX-?o-B----oo--X---X-X?X-B---------B--X-Xo---XB--oB-BB-B-?-oB??----o----X-B---|---o------oEBo-o-X-o
m----o--?-oX?-B?o-B-X---Bo-B?X--X-Xo-o---o?M??X-XB-X---B-|BXX-o---XB-o--oBo-o?o?-B??oo---oo-------?X--Bo--------?---oo-o-B-??--BoT--?-B--o-ooXo-B?-----------B-X---oo-X?o??X-B---X-XX?B-B?o-oXMX-B-B-o?M
XXXX-XXX-XXX-X--XX-XX-X--XX--XXXXXXXXXXX-X---X-XX-XXXXX-XX-XXXXXX-X-XXXXX-XXX-X-X---XXXXXXXXXXXXXX-X---XXXXXXXXX-XX-XXXXX-X--XX-XXXX-XXXXXXXXXXX--XXXXXXXXXXX-XXX-XXXXX-X--XX-XXXXXXX--X--XXXXXXX-X-XX-X
