?------------------------------------------------------------------------------------------------------------------------------------------------------------------------------------------------------X
o------------------------------------------------------------------------------------------------------------------------------------------------------------------------------------------------------M
|------------------------------------------------------------------------------------------------------------------------------------------------------------------------------------------------------|
M------------------------------------------------------------------------------------------------------------------------------------------------------------------------------------------------------|
B------------------------------------------------------------------------------------------------------------------------------------------------------------------------------------------------------?
M----?-?o-?T?BB-oM?oo----o----BoX-X-BX-oo--M?MBoXoTo--B--oBXMBM??o-o-MM--M-Boo?XXM-MB--B-Mo--Bo?oMo--MM--M?--M-XoXX?oo-o---M?-o-?o-M--B-X-B?BX-Xo-oXXB-oX----BooX-MXXoMB-oMoX-B--MoTo-MooBB--X-?--ooBB-X
|M-Xo-o-X--X-------??XMo--oXX?-Mo----BoB?X-----Mo-|B-o--XX-X-----o-XX--oX-o-X--?B----X?-M-BXo-B-X-o-?--o---M--B-o---MX-XMX-----?-----B-Xo?----oXXo--o-?---o---?M-o-M----M?--X?-oM-M|o--??--oMM--Xo-M--BM
M-oBB-o-?M-B---o?Xo--o-ooX--X-o--o-------?M--Xo-?oX-X??--Xoooo--Bo?-?o-----X-MM--oM--?-M---o?---o-----BMoMX-M--?MMB?-o-X--M-BM----XXX-oX--?--?-M-----B-oB-M-?-------o-o?----X----X-X-MM--o----?BMX?--X-v
o??--XoB--B--?M--oo--?-XXXoMM?-Boo--o-XoB--XM-o----o---Moo-oBXB--M-o-?BB--?oB----o-oB-o--X?M-?--B-X-Bo--B-B--Bo------XXM---o-----?Boo-XoMo--B-----X-B-B?--------Bo-?-MX---B-?BM--?-?o---oM-M-----?-oo--E
?---?-B-oM--o--M?M-o--M?XMM---?-B?-XoMB----X-?M-oM-X-----M??-M-M--oM-----?-X-MXB--X?-o--BX----X---oo-o-----?B--M--XBXMB-X--BoT?-X--?-o---o----oMo--o----M-BM---X-??-o-o--o-----X--M-oX----X-o-----??MB-T
M--B---oo--B?----MooM---M------M--Bo---Mo-o----XX----Mo---------?-?--Mo-?-?B----oo---?Xo-M----X-o-Bo--o--XB---------B---X?--M|-o-?B-B-Boo-??XBX-Xoo-X-MB-o---M?MX--?B-?M-?--o-------?---M?-B---?-B----o|
-?--oB-XooB-------o?-BoB---M--M--o-XB-o-MooE-X?M--B---M--o---BX--B--?-X------B--B?Xoo-?---MXBM--M?--XoM-Xo----?BMoM--X--X-X--XBBo-o--?-XXo--?-B---MXXM--BBoo------B-------oMXM-ooM-X-oB---?-o?----?M-o-E
o--BB-o-B?--Boo--oX-X-?-B----B--o?---?o--MMBBX------X----oo-?---?-----?----M?--?--o?-?-o---B--oM--o-X?-----------M-M---?MBXo----XX?B---X-B------o?--------?BM--------oBooXX----Mo--o-M---M--T-BXo----?oX
ooo--?B---BB--?-??B-oX---X----X-?---X-B---oXX--BX-XBX-BB-BBB--o----------B---oB--XX---oB?-T--TB---?-o-o-o----B--X---B--------B?B-B---?BXo-o-??-oB-Boo?BB?-----------To-BoX-------o-o?-??----X------T----
mo?-o---XB--o--o----ooXo-??-o--B--XXB---o-X-?-o-BX--B?--o----?---XBo-------?-X-B-XXo--o--B|X-|--?o-oXBB-?o--o--oB----?o--oXXo---X---X--Bo--X?-oX-o-??-X---o-oo-BX---|X--??o-o-B-?Xoo-X---o-oo-o-?-o|---E
XX-XXXXXX--XXX-XXX-XXXXXX--XX-X--XXX--XXXXXX-XXX-XXX--XXXXXXX-XXXX-XXXXXXXX-XX--XXXXXXXXX-XX-XXX-XXXX--X-XXXXXXX-XXXX-XXXXXXXXX-X-XXXXX-XXXX-XXX-XX--XXX-XXXXXX-XXXXXXXXX-XXXX---XXX-XX-XXXXXXXX-XXXXXXX
