--------------------------------------------------------------------------------------------------------------------------------------------------------------------------------------------------------
------------------------------------------------------------------------------o-------------------------------------------------------------------------------------------------------------------------
---------------------------------------------------------------------------------------------------------------------------------------------------------------------------------------??????-----------
--------------------------------------------------------------------------------------------------------------------------------------------------------------------------------------------------------
--------------------------------------------------------------------------------------------------------------------------------------------------------------------------------------------------------
-------------------------------------------------------------------------------------------------------------------------------------------------------------------------------------------------o------
----------------------------------------------------------------------------------------------------------------------------------------------------------------------------------o---------X-----------
-----------------------------------------------------------------------------------------X-------------------------------------X-----------------------------------------------------------XX----------v
------------------------------------------------------------------------------------------------------------------------------XX----------------------------------------------------------XXX----------f
-----------------------------------------------------------------------------------------------------------------------------XXX---------------------------------------------------------XXXX----------f
----------------------------------------------------------------------------------------------------------------------------XXXX--------------------------------------------------------XXXXX----------f
---------------------------------------------------------------------------------------------------------------------------XXXXX-------------------------------------------------------XXXXXX----------f
--------------------------------------------------------------------------------------------------------------------------XXXXXX----------------------------BBBBB---------------------XXXXXXX----------f
-------------------------------------------------------------------------------------------------------------------------XXXXXXX-----------------------------------------------------XXXXXXXX----------f
m-----------------------------------------------------------------------------------------------------------------------XXXXXXXX----------------------------------------------------XXXXXXXXX----------X
XXXXXXXXXXXXXXXXXXXXXXXXXXXXXXXXXXXXXXXXXXXXXXXXXXXXXXXXXXXXXXXXXXXXXXXXXXXXXXXXXXXXXXXXXXXXXXXXXXXXXXXXXXXXXXXXXXXX---XXXXXXXXXXXXX-------XXXXXXXXXXXXXXXXXXXXXX------XXXXXXXXXXXXXXXXXXXXXXXXXXXXXXXXX
