--------------------------------------------------------------------------------------------------------------------------------------------------------------------------------------------------------
-------------------------------------------------------------------------M------------------------------------------------------------------------------------------------------------------------------
-----------------------------------------------------------------------------------------------X-o------------------------------------------M---o-------------------------------------------------------
------------------------X------------------------------------------------------------------------o------------------------------------------------------------------------------------------------------
--------------------------------------------------------------------------------------------X-----------------------------------------------------------------------------------------------------------
----?---M-B-X------o-X--?M?B-M--X-B---BX--X-MBo--MB------X----XB-?B-X------?X---?-M?-MB-B------B-X-?-----oB???-----X-?-?-BMM--BX?---M-?-o-?M-X-M--BX?-X--M-BMMXoB?-?-BX-M-------X--?-X--?--?M---?---XBX-
--o-oXBBoo------MMBMXBo-oo-oB---M---XX--------MX?oo----?BB-X--X-?--?----M-B-X?--o--o--oB---BX-MoBX?-X?---X--o--XXBM-BoX-o--o---X-?-X-?o-X---??M-XM----M-----o-------X--?-X-M-BoB-Bo--M-M-BM-----o--B-o--
------ooBMX--------o--?--B-BoB?-oX-M---?-?B--X-------X-------X--o----XXX-X---------X?M?--o---Bo----o-o-o--MM--MBX----M--?B--MX--Bo----MBBX-----?---BX?o--X----?---MM-X--X?-o--Mo?oM-M-XoM---X-Bo-oM-MX?v
-XB-E-B--o-----?-?B---o-?----o---?B-X-M-M-----?--M-X?BXE---Xo---B-?--?--o-BX--o-B---------?B---M--M-BM------X----MB---?----M-o----B------B------B?--Mo?B?-X-B-oXX-o--------X---------??X-?--M--M-----Bof
---------?--BMXo-----------B--------BM--o----B-----Mo--?BM----------XooBM----?--o---o-M?------?--B-----?----o-M-----?-o-?-B-M?-Mo--B-----o----------------------??---X--B----?--B---?oo?--Xo-----B-X---f
-?X-------B---X--------?--Mo?-----?-----------B---------o--o---B--?---B-o-MM---M-?--XB----B--M-o-------o---?-BoMX-?--M-------oM----------MBX-M-X----X?--B-M--M-X---X-------XM-----?-------B---o---B--X-f
---X-----?oM---B---X?X--BXo--B-----------XXM?-o--?--M-oM-o------B-o--B------M-X--o-------Mo----Xo-B--M-?------M-?o---o?M?-------------M?----B---BX-Xo----?----?M-----M--oX-B---M?--M-M---M----B----oX--f
---M--M---------X--M-X-----X--?--X--B-EM----o-------o---?X-XMM?----X-----------?-M?----?------B-o---B-?--??----B-----oo-o---X?B?X---M---?B---B--o-X--B-------o---BBMXo---B-o-XX-o--o-o-----?-------M--Xf
--X---o-----T-----Xo------X---o---E---B--------X------XX----o---o------X-----o--------------X-o-oo------o--X-------X------o------X--o---------X-------X--------------X-------XX--------X---o-----------f
m-----------|X--X----X------------B---X--------X------X----XX--------X-X----XX----------------oo--------------o-o---X-----X-----------X------X----X-------X-----o-----------X-----X------X-----M-------X
XXXX-X--X-XXXXX--XXX-X-XXXXXXXX-X-XXXXXXXXXXXXXXXMXX-X-XXX-XXXXXXXXXXXoX-X-XX-X--XXXXX-X-XX--X--XXXX-XX--XXXXXXXXX--X--XX--XXXXX-X-X-XXXXX-X-XX--XXXXXXXX-XX-XXX-X--XX--XX-X-XXX-X--X--X-XXX-X-X-Xo-X--X
