?------------------------------------------------------------------------------------------------------------------------------------------------------------------------------------------------------X
o------------------------------------------------------------------------------------------------------------------------------------------------------------------------------------------------------M
|------------------------------------------------------------------------------------------------------------------------------------------------------------------------------------------------------|
M------------------------------------------------------------------------------------------------------------------------------------------------------------------------------------------------------|
B------------------------------------------------------------------------------------------------------------------------------------------------------------------------------------------------------?
M-o--?-?o-?-?BBo-M?oo------o--BoX-X-BXooo--M?MBoXoTo--B--oBXMBM??--o-MM--M-Boo?XXM-MB--B-Mo--B-?oMo--MM--M?--M-XoXX?-oo--o-M?-o-?o-M--B-X-B?BX-Xo-oXXB-oX----BooX-MXXoMB-oMoX-B--MoTo-MooBB--X-?--ooBB-X
|M-Xo-o-X--X---B---??XMo---XX?-Mo----MBB?X-----M--|B---EXX-X-----o-XX--oX---Xo-?B----X?-M-BX--o-X-o-?--o---M--B-----MX-XMX-----?--X--B-Xo?----oXX---o-?---o---?M---M----M?--X?-oM-M|o--??--MMM--X--M--BM
M--BB-o-?M-B-B--?Xo--o-oMX--X-o--oo------?M--Xo-o-X-M-?M-Xoooo--Bo?-?o-----M???--oM--?-M---o?-M-o-----BMoMX----B--B?-ooX--MBBM--M-XXX-oX--?--?-M----BM--BoM-?-------o-o?----X----X-X-MM--o----?B-BB--X-v
o??--X-B--B-------o-o?-X-X-MM?-Boo??o-X-B--XM-o-o--o-M-Moo-oBBBX-M-o-?X---?------o-oB-o--MoM-?--B-X-Bo--B-B-oBo-?X--oXXM---------?B-o-Xo?o--B-o---X---Xo--------Bo-?-MX---B-?-o--?-?o---oM-M--------o--E
?---?---oM--o--B-MBXM-M?XBB---?-B?--oMB--o-X-XM-oM-X-----M??---M--oM---B-?-X?MBM--X?-o--B---------oo-------?B--M-oXBXMB-Xo-BoT?-X---M----o----o--X-o---oM-BM---X-??-o-o------o----M-oX----X-o---MoMoMB-T
M-oB--ooo--B?------o----M------M--Bo---M?Xo----XX----Mo-----o---?-?---o-?-?B----ooo--?Xo-M----X-o-Boo----XB---------B---X?--M|-o-----oo-ooBo-?XBXoo-X-MB-o---M-B---?B-??Bo--ooM-----?---M?-Bo--?-B----o|
-?X-oBoXooB-------o?-BoB---M--M--o-XB-o--oo--X?M--B---M--o--XBX--B--??X------B--B?Xoo-?---MXBM--M?--XoM-Xo----?BMoM--X--X-X--XBBo-o-BM?XBB-??-B---MXXM--BBoo--X---B------XMoMX-oo----oB---?-o?----?M-o-E
o--BB---B?--Boo---X-X-?-B----B--o?---?o--BXo-X--?---X---Moo-?---?-----?----M?--?--o?-?-o---B--oM--o-X?-----------M-M---?MBX-----BMBo---X---------?--o-----?BM--------oBooX-M---Moooo-M---M--o-BXo----?-X
ooo--?B---BB--?o--o-oX---B----X-?---X-B---oXX----oXBX-BB-BBB--o----o-----B---oB--XX---oB?-T--TB----oo-o-o----B--X---B--------B?B---?--BXo---?X-oB-Boo?X---------o---To-BoX-------oX-?-??----X--E---To---
mo?-o--o-B-----oooB-o-Mo--?-o-oB-oXXBB--o-X-?-o-BX--B?--o----?---?BB-------?-X-B-XXo--o--B|X-|-X?o-BXBB-?o--o-oB?X----?B-oXXo---X-o-X--Bo--X--oX-o-??-XXB-o-o-o?B---|X--?T--o-B-?Xoo-X-----oo-M?--o|---E
XX-XXXXXX--XXX-XXX-XXXXX---XX-X--XXX--XXXXXX-XXX-XXX--XXXXXXX-XXX-X-XXXXXXX-XX--XXXXXXXXX-XX-X-X-XX-X--X-XXXXXX--XXXX--XXXXXXXX-X-XXXXX-XXXX-XXX-XX--XXX-XXXXXX--XXXXXXX-XXXXX---XXX-XXXXXXXXX-XXXXXXXXX
