?------------------------------------------------------------------------------------------------------------------------------------------------------------------------------------------------------X
o------------------------------------------------------------------------------------------------------------------------------------------------------------------------------------------------------M
|------------------------------------------------------------------------------------------------------------------------------------------------------------------------------------------------------|
M------------------------------------------------------------------------------------------------------------------------------------------------------------------------------------------------------|
B------------------------------------------------------------------------------------------------------------------------------------------------------------------------------------------------------?
M----?-?o-?-?BB-oM?oo---------BoX-X-BXooo-EM?MBoXoTo--B--oBXMBM??--o-MM--MEBoo?XXM-MB--B-Mo-oB-?oMo--MM-oM?--M-XoXX?-o-----M?-o-?oEM--B-X-B?BX-XoooXXB-oX----BooX-MXXoMB-oMoX-B--MoTo-MooBBooX-?--ooBB-X
|M-Xo-o-X--X----B--??XMo---XX?-Mo----XM??XX----M--|B---oXX-X-----o-XX--oX-B-X--?B----X?-M-MXB-o-X-o-?--o---M--B-----MX-XMX-----?-XM--B-Xo?----oXX---o-?---o---?Mo--M----M?--X?-oM-M|---??--?MM--X--M--BM
M--BB-o-?M-BMB-o-Xo--o-oBX--X-o--o-------?Mo-Xo-o-X-M-?B-Xoooo--Bo?-?o-----M-oX--oM--?-M------M-o-----BMoMX----B?-B?-MMB--M-BMM-X-XXX-oX--?--?-M--M-Mo--B-M-?---?---o-o?----X--o-X-X-MM-------?B-oB--X-v
o??--X-B--B---o---o-o?-X-X-MM?-Boo--o-X-B--XM-----oo-M--oo-oBXB--M-o-??---?-B----o-oB-o--XX--?--BMX-Bo--B-B--Bo--X---------o----X?B-o-XoM?--B-o-oo---o?M-----o---o-?-MX---Bo?-o--?-?o---oM-M----X?--o--E
?---?---oM--o--B-XXM?-M?MBo---?-B?-XoMBo---X-B?-oMMX-----M??-M-M--oM---B-?-X-B-B--X?-o--BX----o---oo-------?B--M-oXBXMB-X--BoX?-X---o---------o-oX-o-o--M-BM-?-X-??-o-o------o----M-oX----X-o---M-MoMB-T
M--B--Boo--BBM?--Mo-------M----M--Bo---ME-o----XX----Mo-----o---?-?--MM-?-?B----oo---?Xo-M-o--X-o-Bo-----XB---------B---X?--M--o-?X?Moo-ooBoM?XBXoo-X-MB-------BB--?B-??-o---------X?--oM?-B---?-B----o|
-?--oB-XooB-------o?-BoB---M--M--o-XB-o-B-oo-X?M--B---M--o--?BX--B--?--------B--B?X-o-?---MXBM--M?--XoM-Xo-o--?BMoM--X--X-X--XM?o-o--MXoB?-?--B---MXXM--BBoo--X---B------X-oBX-ooXBB-oB---?-o?----?M-o-E
o--BB---B?--Boo---X-X-?-MT---B--o?-o-?o-o-XM-X------X---o?o-----?-----?----M?--?--o?-?-?---B--oM---oX?--o--------M-M-o-?MBX-----MMB?--oX---------?--------?BM--------oBooX-M---Moo---M---M----B-o----?-X
ooo--?B---BB--?o-oo-oX-o-X----X-?---X-B?--o-X--BX-XBX-B?M-BB--o----o-----B---oB--XX---o-?-T--TB----Bo-B-B----B--X-B-B--------B?B-----?BXo------oB-Boo?X-------------To-BoX-------o-o?-??o---X--o---T----
mo?-o--oXB--o--oooB-o-Xoo??-o--B--XXBB--o-X-?-o-BX--B?-------?--XX?--------?-X-B-XXo--o--B|X-|-X?oB-XB-o-o--o-ooB-----oB-oXXo---X-o-X--Bo--X?-oX-o-??-XXB-o-oo-B----|X---Xo?o-B-?Xoo-X--?--oo-B?o-o|---E
XX-XXXXXX--XXX-XXX-XXXXXX--XX-X--XXX--XXXXXX-XXX-XXX--XXXXXXX-XXXX-XXXXXXXX-XX--XXXXXXXXX-XX-X-X-X--X--X-XXXXXXX-XXXX-X-XXXXXXX-X-XXXXX-XXXX-XXX-XX--XXX-XXXXXX-XXXXXXXXXXX-XX---XXX-XXX-XXXXX--XXXXXXXX
