|--------------o-----------------------------------o--------------------------------------------------------------------------------------------------------------------------------------o-----------TB
M-------------------------------------------------------------------o----------------------------------------------------------------o-------------------------------------------------o--------------Mo
-----------------------------------------------o--------------------o-------------------------------------------------------------------o--------------------------o----------------------------------oo
T------------o-----------o----------------------------------------o--------o----o-------------------------o----------------------------o--------------o---------------------------o-------------------EM
oo----------------------------------------------------------------------------o--o----------o----o------------------o-------------------o-------------------------------------------------------------B-
MB-MM---B?-M----o-B----oM-?-E--X?B-B---Xo--B--M-E?B------B?-o-X-M-M----o-----?--E---M-E?----M-BM---o-o--o---?B-?-X---------BE---B?--?-M--X--E---?-o--BoXM-o-X-o-o-----E-o-EBo--M--BX--X---E?-E-----?--X|
X--E--o---E-------M-?E--B--X-X-------B--?-M--B-?---o----X-?X-o----B---E---X--X-M-----o---------B---E--o-oEB?--o-X-B----o---X?BMB-E-oM-?--B----o-?Bo---------X-o----M---M-M?-Bo--MoM-----oo-X--?B-----EE|
-E--BMB-?-o---------?Xo-??--o------------oo?----X--o-o-?o---M-M-------B--?-o---oX-----M---B------??o-oMoo-M?---?-o-----B--X-B---B---M---B--?o----o-----o--o-----XBM-----BXX-o------??-?----?--X?---X---v
T-------------o-?-----o?X?---X-MEoEMM--o----X-E-o---M---?-o-?---E-----oEo---XM?-?X-M--MB--o--o---?M--o-M-----E-XB-B-MM---o--?-o-M------X-o-o--B-M--E-M-EX---E?BB--EM-E--------BoE--------o-?------o---MB
B----E-E-------o-MEE----BM--EEM-?-oM--BXoEE-X?---XoE--o---------M---M--oBB---M--E-M?XE-E--B-----?-MMX--------oo-E---M---o----------?---o?X--MBBoB------oM--o-EoEB------oE---ME-o--oE-oM--oE?------?---Mo
|-----X---B--------Xo--o--EXB-?--?-o-?M?M---?-----BX----X-o-o-?-------?-o-??--M---?-E--oXE----XM--BM-??-----oo-B--?-XE---X-------X--?-XM-X-oM----oXo?-M?M--BB------X-oX-----?---B?----------B--------?MM
?-M--E-?------M----o-o--oB------B---------o-ooME---X---X----X-----M-----X-oE---E---BE?-?-M-?-?-?XXEE----M-X-oEEE--o----XM--MBM-B------M--M------o--o-X----???--?--------B--oB---E---E----M-----?o?---EB-
o--o----o-o-E-?-X---XBX-?---o-----o---------M---EX-----------X-?X-------M-??BX-----o-Xo--E----MM?--E-B---X-X---M----o-BEB-o--?o--XE-----M-E--oXM--------o--ME-XB----BBo-M------E--o---------E--------EXX
o-------B--o--XX--o?---X-B--B-?-o-X-??X---o?----o--?--EoBXEB--?---o-o---o--o--o-XE--B---o---o-B--o-----B-B??----X--o-E----X?---BX-X--BE--------E-o-Eo------X--o-?o-?----B----Xo-----?--E-X-o--oB-E?---X|
m-o-E-o-X------?B---o-X---X-E--XB----Eo-----------X---------X-----XE?--o-?BX----o----B?-oo--?---B?---o-X---XX-o--B---X--EX-o--?--?o--B?-------E---?------o----oX---o-E--?----XXE----o-----E-------?-o-?E
XXXXXXXXXXXXXXXXXXXXXXXXXXXXXXXXXXXXXXXXXXXXXXXXXXXXXXXXXXXXXXXXXXXXXXXXXXXXXXXXXXXXXXXXXXXXXXXXXXXXXXXXXXXXXXXXXXXXXXXXXXXXXXXXXXXXXXXXXXXXXXXXXXXXXXXXXXXXXXXXXXXXXXXXXXXXXXXXXXXXXXXXXXXXXXXXXXXXXXXX
