?------------------------------------------------------------------------------------------------------------------------------------------------------------------------------------------------------T
X------------------------------------------------------------------------------------------------------------------------------------------------------------------------------------------------------E
X-------------------------------------------------------------------------------------------------------------------------------------------------------------------------------------------------------
X------------------------------------------------------------------------------------------------------------------------------------------------------------------------------------------------------B
o------------------------------------------------------------------------------------------------------------------------------------------------------------------------------------------------------E
T|-oMBo??-MB-XXB-?ME---oo-M----o?MBooo--MM?oo-ooXX-oB-oXo?oEoBXMo-oo-X-X-BX-o-?-Boo-X?M?XXE----?B?--X-oBBEMXMooo?B-BMX-o---oXo---o-Bo-EMMooMX?o?oMB--ooXM?oEM?EM--oX-XXXM?-BBM--XM?M-B-??oXX-oBM-MB-XE-M
oX-o--B--M--X-?-BMXXB?oM-M-X-o?-----o-X?---X-?XMo??M-oB---B?o-M-MoBBooE---o-ME---?ToM---E?BMoM----oX?MoB?B---BMo--B---XX|o-o-?BoMX--?XB--Mo-M------?-BM--B?MMMM-BX--?-oo-------oo---o-----B-o---o----BBB
--Mo------oX?B---o-MB-B-?--X---M-X-oM---T|-oX-B-?---oB-o-o-Bo-------XMXoEEX-B?o?--|M-?X?B?X-o--|--BM-MXX?-?-?--B------MMXB-M-----BX?BB?------B---X------MBX--BME-ooM-?--o-o--XB-----X-BBM--oXoXoMoX?T--v
MB-X---??M----o-BMM----B-MMB----Mo-B---XXXXB-B----X?o-BB?B--XoX-X------MM?-X-B--MMX-X-o-M--XMMMX-?------XB-?--B-X--Xo---?---Bo-o--o---E?--XM-----oo-?X-M---XXXM?M?--B-o-B-o----M??XBM?----XXoX-B-o--|--?
----oMB---|--oX-----Bo------MM?B----ooo-M-M-M---o-M-MX----M-----oMooXBEM?ME---o----oo--------------B--o-M-M-------EXBB-o--Mo-B-X--oXMM?---E-?oB?M-?o--o---o-M-----o?--M---B-XEo-------MX--M--oB-M?EoX--o
-M-B------X--MBo-M-X-M-B--B--MXB----?-BB-o---B??B--?-o----BMM?--X-?M??BM-XBo--?B--M--XoX--XM---Eo---o?XB-B-B-B--oX?B--X?--------M--B--ooMXBX-M---E-E--B-oMXM-o-B--X--?-o-o-B-???Mo-oBX-B-----M----BM-B-T
X---B-M-?B-----X---BB----X-B?-X--Xoo-o---?-MEB-?-BX--B----B---o-Xo---Mo----MM----M-?o-Mo?-X-oBXB?-?-?-X-E---X-o-M---X---M-MXB?o---o--X?-M--BX---MX?MXo----?-M----B-?--o-XM---o---BXX--?--oX-?-o--M--o-B-
?-?----B---E-o---MB---o--?B--o-?-----o-B--X?M-E-E-----?BM---?----?----X-ooX----M--?----X---??------B--XMB?o--o-M-o?B--X--B----oB-??M---o--B-M|-X--|-oB-oX--B-B-?--o-M??-X-?oo-?---?TMo---MBB-X----M--o-o
|--??-o--B-M-?X-o--B-?-?---o--o---oo-oB-Bo--XXB-XX-o---------BoBB--oo-?-XX-B------X----B-E------o---?BX-?o-B----oo--XE--X-MXM-B---------BE-X-Xo---XB--oBoBB-B-?-oBB-----o----X-B---|---o--MXXXoEBo-o-X-o
m-M--oo-?-oX?-B?o-B-X---Bo-B?X--X-Xo-o----?B?-?-XB-X--|B-|BXX-o---XB-o--oB---?o?-B??oo--BMo-------?X--Bo--o-----?---o?-o-B-??--B-o--?B?B?M-ooXo-B?-----------B-X---o--X?o??X-BX-oX-XX?B-B?o-oT?B-B-B-o?M
XXXX-XXX-XXX-X--XX-XX-X--XX--XXXXXXXXXXX-X---X-XX-XXXXX-XX-XXXXXX-X-XXXXX-XXX-X-X---XXXXXXXXXXXXXX-X---XXXXXXXXX-XX-XXXXX-X--XX-XXXX-XXXXXXXXXXX--XXXXXXXXXXX-XXX-XXXXX-X--XX-XXXXXXX--X--XXXXXXX-X-XX-X
