|------------------------------------------------------------------------------------------------------------------------------------------------------------------------------------------------------o
X------------------------------------------------------------------------------------------------------------------------------------------------------------------------------------------------------X
?------------------------------------------------------------------------------------------------------------------------------------------------------------------------------------------------------B
E------------------------------------------------------------------------------------------------------------------------------------------------------------------------------------------------------M
B------------------------------------------------------------------------------------------------------------------------------------------------------------------------------------------------------T
X-B-B--B-Mo-o?-MMBM--M-oX-B-Xo-oo-EBoB-?-E-B-?--M?--M?B?E--|--o?B-B-M?B--oX-??M?ooo-Bo--?-oM-?o?BB--?Mo-XoBM-o-?--XXX-o--?--ooMM??oo-?oX--XMXBooo--?B-E-Boo-XoooB-X-oMo?B?-?-|-MoX-M-BM?MoB?-???BE--oB-E
TB-o-?M---??M-E-----o--X-o--XM-X|MB-M---BXX-X-?-------MM?X?XooX----M------XB----E-Bo---?--X---M---Xo---oBB--ooX-M?-M---MB-MoXB----M-------X-B-?--??-B?MM-Xo-XoM----M--B---M-MXB-BM--o----o--o----Bo|?-o-
---X----oM--B?XM--X?M?oB-MBMM---XBX--BMXX?X-oX-B--ooXXo-X|--??---o--oB??-o--B-MBBX-E-o---E-BM--??-o?M?B---o-------X-o-o--M-MM-BB----???-X-?o---?X---oB-Mo--oBE--B------MX----?----MoX--BM?--oo-o-XXX-o-v
|-ooB-o---MMX-X-XXX---o-------B?E-oM---o-X?BBoo--XMMM-B-BX-X--MX?M-EB---?M-M-?--?-XM-Xo??B?---o--o-------?M-EooMB--o----B-X-------------?--?-?--?-o-X-o-?o-XBM?---B--M---?o----M-X-XB----BBBX--X-?XX?M-|
E?oB-oo-MB--M-?o?----M----XMBXBB??----oo-?---B-ooB-----o--ooX--M-MBBM?MM--o-B-------o?M?-ooBXoX-MX-o-M-MX--XM?X----oEMBB--E-Bo--?o-?M-Eo-|o-?-XX---BBE?--oB-B---MX-oo--oo-X?--M-EX-B-?-XX--o-o?-X-Eo---M
|-M----M-----B-M--?-?-X-X-----XoB--B?-B-B-??o-M-M-XM-Mo---XXM-o-B--XooMBM--X--?M-MXMo--B--?--Xo---?---M-Xo--o-----?BX---oE?B-?------BM?B-X-o-oX?o-B-XB---X---?X?--o-?XoBX-o-o-BBM?-----BoM?Bo--oMB?MB-B?
-?--BB--M-?-M-M--M------B-MXooMB--?----M----?---------Bo---M-MM-----?X---o?XXBXMX----M--o--?-?X-----B--BM??oB--BooooX-M-XB?----o-BX--M----Mo-B---o--?-X--oX-?-B-o-BM-XB-o-BXBXM----B--o-B---XMMMXTo----M
M--M------------o-----X-----X---oXBM?-B-BoX--BM--BMBX--X-MB-o--EB--?-Bo-o--MXXMX-X-XoBo-XBB-T-oEMBoB-|-----B-?--M?-B-M-XX-----?X--oo--?X?o-----o?XM-----o-XE---XM?--o---M--M-XoBo-M-?oM---MM----oXoMBMBM
|X--BX-B-oo-?X-?--?-------oB-o-----o-E---?oXo--oB---?Xo----?-o??-??-?----o-B--?--oBB--X-----|?BM--o-oXo---?---------B-?oB-oo-o-oB-B----X--BBXB-B------BooMMMM------?X-Bo----?---X--o---?B---T?-??o?---B|
m--X--?-o??--oo-oo--o-oBB---o--ooX-XBB??B-BoXXoo--|X--o-??o-B---B----X--B?-----oMB--oo--?X-BX---??X---B-B?--?Xooo?X?---o-o??-?-X-o--B|-Bo-----o-oXX--o-oXB-BB||XBoo--?-o-oB?-o-o?-?-Xo-Bo-X-|----o-X-?-o
XXXXXX--X--X-XXXXXXXXXX--XX-XXXXXXX-XXX--X-XXXXXXXXXXXXX--XX-XXX-XXXXXXX--XX-XXXX-XXXXXX-XX-X-XX--XXXX-X--XX-XXXX-X-XX-XXX--X-XX-XXX-XX-XXXXXXXXXXXXXXXXX-X--XXX-XX-X-XXXX---XXX-X-XXXX-XXXXX-XXXXXX--XX
