--------------------------------------------------------------------------------------------------------------------------------------------------------------------------------------------------------
--------------------------------------------------------------------------------------------------------------------------------------------------------------------------------------------------------
--------------------------------------------------------------------------------------------------------------------------------------------------------------------------------------------------------
--------------------------------------------------------------------------------------------------------------------------------------------------------------------------------------------------------
--------------------------------------------------------------------------------------------------------------------------------------------------------------------------------------------------------
--XMBMBT--B?XMBXX-??M----?MX-M?---MB-MM---Xo-X---M-?M---M?oBX------TM--------?X?-----MMMo---B------oX---?----X----?M?B-X--BM-XXM-B--?BX-MM-M?-oM-----M-?---MB-XB-o-X-B-MM--?X---B--MBBB--B---Moo--X-E---
------o|-Xo----X-?oo---??o-?----B---B--?-M--M-oX--X--MXM--M--MM--?-|--?----?oo----X----oX-?---XB?-XB?B--oB--X-MXX-----B?B---XX-o?-X---B--oX-oMXoTBM-Boo-?-X-o---XBBMM-Mo-B?oB?---B-----BB-MXM-X?M--B?---
-B--?M-X?MMX--oBM-?---?-o-M--XM-oo?--?-o-----BM--X----M-X-oMB--?--?X-----M?-o----o--XM--M-oBM---oX---o-o---------B-?---o-o-XoX-Moo-----X-?X---o-|----BBo---M-?---o---?-----X---B------?-----oBX---oo-XMv
--??-oB--o--?M-----B---Bo---E--XXM--o---------o----MMM--BX-o--?o-?-M-XoM-o-X-------M-o-?--X-----o--X--Xo--B--BXoM-B-M---?XXB-?--?-MB------oX---?X---?--B-M--M----XX-----B--X?B--?XMX?---?--BB----M-----f
---oMX-----B--------X-Mo--BXMB--?--?-o----B----o??B----X--Mo------o--?--B--B-BM-EM----Mo-?-?B---?-??M-oM----M--X-X------o--o-o---B-o?--X--BX-----oX----oBo-X---oM-B--BX-o?-M--?X---o-M-----o-----oE--?-f
-o-B----X--oBB-B--?-To-X?M----?Xo---o------X---o-o-----oo----XMo--B---XM--?-o--M?oXB---X-o-o-?X-o-----X--B-B--XX--X------------------X?-BX-B-?-X-M-MEB--o-------oB-----X--X--XoX---Xoo-MB----o---B?o---f
-----oXMB-------XM--|X----MBBBo-X-B?X------MX-BM----?M-BXM-----XBB-?--?o-?o-?M------B---?M-?B--?-?X--------oM------??XB?M----B---X?MX-o---?o-o--B---?o---B---------o---X-MB--------B?----X-oo-?X-o-?---f
-?-X?X----?-MM-BX---X?---?-----X-E---Mo--o-o-------?-------X?X-M-----Bo----Xo-X-Boo------oB---X------X-BM--Xo-?---?------E-MXo-B-Xo------Mo---XXo-Eo--??Mo----?M?--X--B---oX-?--M?---M--E-B?---X--X-X-Bf
-----------X----XX--X----------MBMB--oX--X-----o-X----------------T-X-Xo---------o----X-----X-----------------o----------B-o-----------X--X--Xo-------o--X----o-------o---------o--To--XM---oX----X----f
m---X-o------o-XoX--------o-------------X--------o--------oX-X----|o---------o---X-X--X------X-o----------X-----o--o-----o-----------X---o----X----o-----X--o-----X---------------X|---------X----o----X
X-XX-XXX-XX-X-XXXX-X-XX--X-XXXXX-X--XXXXX-XX--X-XX--X-XXXXXXX-XX-XX-XXXXXXXX--XXXXXXXXXXXXXXXXXX-XXXXXX--X-X-XX-XXXXXX-XXX-XXX--XX-XX-X-XX-X--XXXX-X-X-XX-X-X--XX-X-XX-XXXXXX-XXXXXXX-X--XX-XXXXXXXXXXXX
