--------------------------------------------------------------------------------------------------------------------------------------------------------------------------------------------------------
---------------------------------------------------------------------------------------------X------------------------------------------------------------------------------------X---------------------
----------------------------------------------------------------------------------------------------------------------------M---------------------------------------------------------------------------
--------------------------------------------------------------------------------------------------------------------------------------------------------------------------------------------------------
-------------------------------------------------o--------------------------------------------------X---------------------------------------------------------------------------------------------------
----o--E---X----------?X?B---B---------?oM-oB----?--MM?----X------BB------M--B----o-B----X-------------M?M?Xo?----------B------?--X-M--oB-oB-BXX-X---B-----B?----o---B--BM----B--B-XBBEM--------B-B-----
--B----o------BB--------oo---oE---o--o--M----X-B-----o--E-?X---M-----?-----M-o--X???o-o----oo-oM-----------?B-----o-o----XM-?o----oM----o--o------------X-------o?-o------?--X-----X-XXo---M--??-----o?-
-------M--------Xo----X--X--M-X-----?-oo---------MB--oX??Mo-o-------X-XEM-o--o?-o-----------BM---X----X-X----?-X---E-----oo--------o--XXB----B----o--?BooBM-o---B-BMXo-o----Eo--o------X--o---oo-?---Xov
---?-M--o--X-----?B--oM?o---oXo-X-E----B-----?---------o-Eo----B-B?B--MM----o---BM--M--?-o--o----EoBBX-----M---o---B------o----?o---Bo-----------o------B----B----o--o---Mo--oXo-------?M-MMXX--X---E--f
-----o--o--?-X----o--M--X--?--?-M-?----------------oEo-M--------------o-----o-------o--o--?MB-B?M-M--?----E-E--?-B-------o-B?--o--M--?--XoB-X---BB-?MX-------o-E-------------------------?---oo--o-M-oBf
------o------o-o-------------------B-X--------oX?-B-M-M----E--?---X--?----o-----------B----o-oo-o---X-oE-XX?X--oX-B--B------o------o----o---M-o----o---B--?----?-o-oo-E---------o-X-----X-----X--------f
-??------------------B--E---M-B?o--------E----X---o-----M--E-?o--------?-----o------MMoX-----?----oo-------o--o-M----------------?---oMMX-----M---B--Xo-M----oX-MX-M??M---------------?-o--o----Mo-X--Xf
-o-o-BB-------------X-MBXX?o-o---X?-----BB-o-M-MEo--BM-E---BB-----oM-X---M-B?BBX--E----B-o?XoX-B--o--o----E--XE-o------------o------X?o-X--?-?-o--o-o-B?------------o--E-Mo?--X--E------?--XX--o----o--f
--------------------------o--------o--o--o-----?X------B---------------o----oooo-XM------------------X---X--------------oo-E---------------o------o-o-------X----------M---------M---------------------f
m---oo--------------------------X---ooo------X--B--------------o--??o-------------------------------------------oo-X------MXo-o------o-o--o--X-------X----------------------------------X-------X------X
XX-XXX-X-XXX--X-X--XX-XX-XXXXXXXX-XXXXXXXX-X--XXXXXXXX-XXX--X-XXXXXX--XXXXXX-XXXXX-XX-XXXX-XXXXX-XXX-XXX--XXXXXXXXX-XXXX-XXXXXXXX-X-X--XX-XXXXX-XX-XXX-XXXX--X-XXX-XXXXX--XXX-X--XXXX-XX--XXXXXXX-X--XXX
