?------------------------------------------------------------------------------------------------------------------------------------------------------------------------------------------------------o
-------------------------------------------------------------------------------------------------------------------------------------------------------------------------------------------------------|
o-------------------------------------------------------------------------------------------------------------------------------------------------------------------------------------------------------
-------------------------------------------------------------------------------------------------------------------------------------------------------------------------------------------------------|
T------------------------------------------------------------------------------------------------------------------------------------------------------------------------------------------------------E
M-oMB-----o--oMoB-----B-?oo?M-M-MXoo--B-?---?-B?----M???X?-o---oMMXBoooMXXB-?o--o-oB-Mo----B?o-oBo?X-oo-oo--M--BX--B--X-Eo-BX-ooo?---M----M?oo-M-??MX--o-Boo?o-ooXM-oBX--?-?-XoM-o-E?-ooMMBB-oo-o?o-ooMT
oo-o---BM-X?XX-?-XM--B-o-B?-oX---X-XB--o-B-BoM-ooo?--o--?--B--B?-o-oXBo-B--B-B??-BB-?-M-XM-----?-B-?oB?ooX----?--------BXM?--oMM----o--?-o---M?-M-o-o--BM-BXoMo?BMo-M-ooXoo---X-MM?M-XM?--o-oBoMMo-oBX-E
XM-o--?-----XB---o-M---??o---M-oo?-----MB-B-X---o--o-?oX-M---X-----oo-?o--o-ooo-o---oBoo------oo--B-M-o-oMME---Mo-?-M?------B---?--BB-M-oo-M-ooM-oM-?M---o-X--X--o----?--M--X-o-----X---Bo-----o-?oB-?ov
T---o---Xo--B---o--ooXX--?BM---B-o--o------M?oo-MM-MX-MX-----oo--?-oM--M-o?o--o-Mo-oB---?-XM-X??o-----B-?-??--M-X--B--ooo----B-B-??----?XX---X---o----o--oo-oBMoM?oo-B-?X-MoX-B-X-o?--Moo--B-?B-----BoM?
T-MBM-o----EoMXo-ooMB-??-o--B----??-MBMo-----M?oo---B---B?Bo-oX?--oXoXo----Xo?MX--MM---o-M?oBo--?oo-o--------?--oB?--MB-M-oM-------MX?MooM--MoX--B?-MB??ooo?o--o-o?MB---ooooM--B-oo-o--oo-o---o--oM----o
oo-o-BXM-oMM--oM----o---oo----oMM-oX---?X--BM----o---oo?o---oX--?M--ooX-ooo-oo--o---MMo?-o-oo?o---Bo-M-Boo--ooo-B--oo--M-BM------o--Bo-?--X--M?-M----o--BBB-?ooo-?---B--BMoo-Bo--X----B?-ooMo--?B--X?-oM
oM-MX--BX?oB?oBo-X-M-o--?-Mo?-B-oo-B---o---o-M-?oBoo?B?ooM?o?-oMo--MMoo-MBX-B?MBBMoo--Bo?B-BM---?--ME-?-?--oX--X-X-BB------o-M---MoB-o--o-M--ooM----oXoB-----Booo-MB-o-B-o--?-ooX--oo----o-oM-----oB-??X
MoMo-Bo------X---X--M----o-----B-M---ooo-o?-oo-o------o-------M-o----MBM-o-?---------M--o-o---?X--ooMo-M-o--MXo-o-Xo-o--MBXB-oX---Mo-o?-X-o--oo-?o--M-o-B-o----MXM--B----X----X-MMo-?o-XoXo--XB?--X--ooT
----o------o---o-oo-oo---o-o----X----X-X-----o-o---------o-XoX--oo------o------T--Xo----o---XX--o---oX-------oooX--oXXo-----T-------X---o--|----------X-------o--o--o----------X-oXo---oX--oo------ooo-E
m---oX--o--Xo----oooo----Xo---X--ooooooo-oo--X----o-oo------o---X-------ooo-oo-|oo-o-ooo--o-o-oo---oXX--o----oX-o-o----o-o-X|--o--oo----o---o-o---o-o-o--X-oo----X---o---o--oooX--oo---oX-ooo---oo--Xo-?
XXXXXXXXXXXXXXXXXXXXXXXXXXXXXXXXXXXXXXXXXXXXXXXXXXXXXXXXXXXXXXXXXXXXXXXXXXXXXXXXXXXXXXXXXXXXXXXXXXXXXXXXXXXXXXXXXXXXXXXXXXXXXXXXXXXXXXXXXXXXXXXXXXXXXXXXXXXXXXXXXXXXXXXXXXXXXXXXXXXXXXXXXXXXXXXXXXXXXXXX
