?-------------------------------------------------------------------------------------------------------------------------------------------------------------------------------------------------------
?------------------------------------------------------------------------------------------------------------------------------------------------------------------------------------------------------?
X------------------------------------------------------------------------------------------------------------------------------------------------------------------------------------------------------|
X------------------------------------------------------------------------------------------------------------------------------------------------------------------------------------------------------X
E-------------------------------------------------------------------------------------------------------------------------------------------------------------------------------------------------------
E-Xo-XE?oME?MXo-oo-X?EE--?XoooX-?M?Mo----Xo?ooMoo-?XMX-?E?MXEB--EMEMB-E-EMXBBBX----oE?---BM-EBoB-o-B?-BE?M-XMBMoEXMo?X-XXEXo-XBoE-oXoE-o--X-MEMoBXBM--M-oX?-E-MoX-M-BM-EEXo-oo?XoXEXoo-M?oooo-EoMMoB-B-o
TMMBM--?BXMBEo-XB-?-??X?-BoBBB??---o-EEXM-o---MXB--EMXo--ooBoM-MBBo?o-E-??oo--oo-B-B?Mo-?X?-o---o--oEoB---MEXEEooEoE--o----Mo--B?X-oMo-XoBMM?XXEoME-E?-o---?oE-Mo-BBE-oo?M--oBM-o?XMEo?-M--EX-M--E-Xo--?
--o-XE--oo-?oo?BoXo??E-?-?MoXEMME--B-?X--Bo-oBBB?EX?MMBEB?E-?E?---?MXM-XXXoXEMB--oo--Mooo-o-o-MEE-E-XMXoX??BBEXBM--EM?---oB?MoX-MBB--oo?o-?Boo-M?E--BMB?oM-X--EXB??B-MMX-BE-E?-X------X-X-oM??BoEMXMoB-v
?B-BEXMBB-BX-XooXo----oMM--EoB-oXX---BMB-BoBXoMo???MXXE-EB-??--MEooMEMB-?E-M?X?oo-oM-o--MBoXBM?BoMB---BEEoo---BBBo---BX-o-B-?Bo---Eo-X--o---?-X-EMB?MM--?ooBEM-o--XoEX-MEM--B-X-oEBMBB-?-BBX-?X-B-ME-XX-
|ooBEEM-MEMM-?B----M?-oM?--BMXB-?-B-B?o?EoEo---XM?-oo-?-EoB--EBEo?-?o-oBB-oX-?MXo-MXXXBMooX?-E?-o?MoMo--oEE?o-o-ooM-o-?BEXX--B-EX-o-ooE?oE-X-EooBB-??-EBB?-M-EoB-X--o-XM-Mo-B---?MMX-BoBoE?M?-E---?BMB-M
EB--oBBXoX-BM?---EXoM-o-BB-?XoB-X-oX---XE-XEX--M-o-E-B?-E?-BMBEX-XoMX?oEB-Xoo--ME--EBXXM-B-MXo?XoX----?Bo-XEX-EXB-o-?E---MB?Xo?X----B-XX-XM-E?EXX-oo?M?BX--BMEEo-EMMEo-M-?EB-Boo-MEoBo?MoBEXMEo-?E-EX-B-
?--X-BBXEMo----?--oBoXMoo-?-MBBE-MB??-oBEMBB?-M?XE-EoBBBEEBEE?BM?E----?MME-EMoBMo?MX-o?B-B---EoMoBXMXXEMoEEEEoX--ME?B--?EEE-X-?--oX-XXo-B-MBXB--B----oM--oEXBE-o-oXMoooo-BE-EEXXMMMooMEoo-M--EX-BBo-BMXB
MXB-?oBB-oM-EooB-XX-oXXEBE?Xoo-B--Bo-BEX-oMB---o-?-ooo-oB-X???o-?M--Bo--BoBoXM--BMXBE?-XEXBMM?o-Xo-ME--XB-?M?X-BoM-M-?-Xo-M?Mo-M?-oMXE-ooEEMX?B-----Mo?BEE-?-X-?oMB-BBE-?o-XoX-Xo?MXX-EB-MBMEEBXM--BEBEo
X--oEBB-E-o?oX?X-X-B-B-XBXBBX-oXX-o-oooXoXXB---EBo---BB?oB?-oXo-XB-?--oo?o--oB-X-X---B?XXX-Bo--o-EEo-o---oE---o-XoBo?E?---o----XoEBB-B--oEEBBB-X-??-X?EXB----EB----o-o???---BBXo?EoXoBo--?Bo?---Bo-X-o--
m-E?-oE-B?X?BEX--?o---?-?X-B---?--?oXB----BXo-B?XooEoo--EE-B-BoB---E-o---XEo-oo---XX-XXBB--?---E--B--?Xo?o----X-?X??----Bo-----B?-X-EX-E---o-??oEBXXooB-oB-BEo-E-XoEX-X-X---?B-?oo--oX-oo?X-E??B--B?-BoT
XXXXXXXXXXXXXXXXXXXXXXXXXXXXXXXXXXXXXXXXXXXXXXXXXXXXXXXXXXXXXXXXXXXXXXXXXXXXXXXXXXXXXXXXXXXXXXXXXXXXXXXXXXXXXXXXXXXXXXXXXXXXXXXXXXXXXXXXXXXXXXXXXXXXXXXXXXXXXXXXXXXXXXXXXXXXXXXXXXXXXXXXXXXXXXXXXXXXXXXX
