--------------------------------------------------------------------------------------------------------------------------------------------------------------------------------------------------------
--------------------------------------------------------------------------------------------------------------------------------------------------------------------------------------------------------
--------------------------------------------------------------------------------------------------------------------------------------------------------------------------------------------------------
--------------------------------------------------------------------------------------------------------------------------o-----------------------------------------------------------------------------
----------------------------------------------------------------------------------------------------------------------------------------------------------------------------------------------------o---
--X---E-o-?-------EoXX-oo?----?--B-X----XB--oM-B-----X------?----?Boo-o-----MM-?M---M------?---------X--M--------E---o--------?---E-oB-B------?---M-o-?o?------X-XX------B----EX---------o---?-oM-X---M-
--?o-XB---------BBM---------B--B-o---X-?-o-o--------------??-?-B--o------X----E------EX------?-----X----o-o--M-------X-------B-X-??M-----X?-Xo-----oB----o---------------------E---M---o-------Xo----B--
-ooo-----XB-------?o----?B--------M--o-----o------X----M-oo--o--??-X-o---o---XX---o?MB---X-X---------B-----------?-B---?-?----E----o-E----oo-M-----------?--MX--o----------oo---??o--?---o-X-BX-------?v
-?-B----------???----X-----o--------X?B--------------MMo-o----------B?--M------oX-BoM---XB-o---B-------?-o--------B-M-X------oX----?XXM-B---------o--X----MBo----ooBX-XM-o----B---BM?-B--?o-o---------of
-o---M---------o------B?--X?---B-??--o----o---X-?--E-o---XX---oM--X----o-----X---B------E-----o--o----------X--EB------M---?---?------------EB------M?E----o---BXM--B-E---M-----o----ooE-o---?---M-----f
----Bo-------------o--------o-----X-ooo?---o-----XMM----o--M------o-?B?oX----X-B-o-----BXMo---o---M?-B-o------B---o-B-------------E-----?oX-M---M---oMBE-E-----------BM--B---oo-M------?-M-o----M------f
-X-B------o----o----?M-o---??M?B?--o--M--o?----------X--o---M-----o-----M-----o-Bo----------------o---------E?---------B---?--B-M?MB-B------MoB-------XX--E?M--o-?-X--Xoo-----X?o--Bo-?---MB-???o---?o-f
-?---o----EXE-oM--XE-o---o---o--M---M---E--------?-oB-M----M--B------------?XM?X-o----E-XB-----o--M-oBE-----?-B-------------X-oB---------------EoE-X-----B?--MXX-B----X----M--?-----?-o----------M---B-f
----------M------XX----o-----XX-----o---M------------------o--------X------o--o----E-----o--------oo-oB----------------oo-o-------E----------MX?BB?----oXX-------------------------------------------o-f
m------o---------------o---o-o--------Xo------oX---------o-o-X---------B----X---o------------------o-----------o----------o-------?----------o--X--------X?M?---------------------------o--o---o----X?XX
XXX--XXX-XXX-XX--X-XXXXXXX-X-XX-X--X--XXX--XXX-XX-X-XXX-X-XXXXXXXXXX-XXXX-XXXXXXXXX-XX-XXXXXX--X-XXXX-X-XXX-XXXX-X--XXXXX--X-XX-X-XXXXX-X-XXXXXXX-XXX--XXXXXX-X--X--X-XXXX--XXX-XXXX--XXXXX--X-XXXXX-X-X
