?------------------------------------------------------------------------------------------------------------------------------------------------------------------------------------------------------X
o------------------------------------------------------------------------------------------------------------------------------------------------------------------------------------------------------M
|------------------------------------------------------------------------------------------------------------------------------------------------------------------------------------------------------|
M------------------------------------------------------------------------------------------------------------------------------------------------------------------------------------------------------|
B------------------------------------------------------------------------------------------------------------------------------------------------------------------------------------------------------?
M----?-?--?-?BB-oM?oo-------o-BoX-XoBX-oo--M?MBoXoTo--B--oBXMBM??o-o-MM--M-Boo?XXM-MB--B-Mo--B-?oMo--MM-oM?--M-XoXX?oo-----M?-o-?o-M--B-X-B?BX-XoooXXB-oX----BooX-MXXoMB-oMoX-B--MoTo-MooBBo-X-?--ooBB-X
|M-Xo-o-X--X----B--??XMo---XX?-Mo--X-BoB?X?----M--|B---EXX-X-----o-XX--oX-o-X--?B----X?-M-BXB-B-X-o-?--o---M--B-E---MXoXMX-----?-----B-Xo?----oXX---o-?---o---?M-o-M----M?--X?-oM-M|---??--BXM--X--M--BM
M-oBB-o-?M-B-X-o-Xo--o-ooX--X-o--o-------?---Xo-ooX-M-?M-Xoooo--Bo?-?o-----X??---oM--?-M--------o-o---BMoMX----M?XB?-oBX-?BMBM--B-XXX-oX--?-o?-M--XX-o--B-M-?---M---o-o?----X----X-X-MM-------?B--B--X-v
o??--XoB--B--oo---o--?-XXX-MM?-Boo--o-X-B--XM-o----o-M-MooooBXB?-M-o-?MM--?--------oB-o--?o--M--B-X-Bo--B-B-oBo-?X---X-MM--------?Boo-XoMo--B-o---X-BoX----------o-?-MX---B-?-X--?-?o---MM-M--------o--E
?---MMX-oM--oooB-o-X--M?XBo---?-B?-XoMBo---X-o?-oM-X-----M??-M----oM-----?-X-?-B--X?-o--BX----o---oo-------?B--M--XBXMB----BoB?-X--M-----o----oo---o-oooM-B??--X-??-o-o------o?o--M-oX----X-o---MoMoMB-T
M--B--oo---B?B---Moo----M-M----M--Bo---Mo-o--o-XX----Mo-------o-?-?---o-?-?B----oo---?Xo-M----X-o-Bo-----XB---------B---X?--M---o?--B-ooo-Bo-?XBXoo-X-MB-o---M-BM--?B-??---o-o-o---??---M?-B---?-B----o|
-?--oBoXooB---o---o?-BBB---M--M--o-XB-o-X-o--X?M--B---M--o---BX--B--??X------B--B?XMo-?---MXBM--M?--XoM-Xo-o--?BMoM--X--X-X--XBBM-o--MXMMo-??-B-o-MXXM--BBoo--X---B------X-B-BMXo----oB---?-o?----?M-o-E
o--BB---B?-??BX---X-X--------B--o?o--?oEo-MB-X-----oX----oo-?---?-----?--o-M?--?--o--?-o---B--oM----X?-----------M-M---?MBX------MBM--o--B-------?--------?BM--------oBooX-M---MooEo-M---M----B-o----?oX
ooo--?B---BB--?o-oo-oX---X----X-?-B-XMXXB-o-X--BX-XBX-BB-BBB-oo----------B---oB--XX---oB?-T---B----Eo-o-o----B--X-B-B--------B?B-----B?Xo------oB-Boo??-------------To-BoX----o--oM-?-??o---X------T----
mo?-o---BB-----oooB-o-Xoo??-o--B---XBB----X-?-o-BXo-B?-------?---Xoo-------?oX-BoXXB--o--B|X-|--???--BB|?o--o--oB----?-o-oXXo---X---X--Bo--X?-oX-o-??--XB-o-oo-oo---|X--X?--o-B-?Xoo-X--?--oo?o|?-o|---E
XX-XXXXXX--XXX-XXX-XXXXXX--XX-X--XXX--XXXXXX-XXX-XXX--XXXXXXX-XXXXXXXXXXXXX-XX--XXX-XXXXX-XX-XXX---XX--X-XXXXXXX-XXXX-XXXXXXXXX-X-XXXXX-XXXX-XXX-XX--XXX-XXXXXXXXXXXXXXXX-XXXX---XXX-XXX-XXXX-XX-XXXXXXX
