---------------------------------------------------------------X----------------------------------------------------------------------------------------------------------------------------------------
--------------------------------------------------------------------------------------------------------------------------------------------------------------------------------------------------------
--------------------------------------------------------------------------------------------------------------------------------------------------------------------------------------------------------
------------------------------------------------------M-------------------------------------------------------------------------------------------------------------------------------------------------
--------------------------------------------------------------------------------------------------------------------------------------------------------------------------------------------------------
-MM--X--?-o?-----X--B--X----B--X--M-----B----M--X-B--?----Bo-B-----Mo-?----?o---X-MXXMEX-M--M--B--X?B--B-?-o------X-?MM-?XEo----XBo-B-M?--?--X--?-E-E----M-BE-----B---M?-----?----X-M?--o-X-X---Mo--EM--
---X------------?---------?--------B----oM------?-oB---B-o-X---B----XEo-----o---B?-?B?B-----o-?-oB---M---oo?M-Mo-o-------?B--M-o-----------oX--oBMBBX----?--?---?o-?----o----o-?------------o--o-E--B---
--BoB-o--ooX--B------MoMX---B-BM-?---------M-----BMoo--o--o---o---Xo??---B-?X-----Bo-XB---B--Bo-?o-------------?-oB-oB-?MBB----M---?B--?Mo--?-o--?BM-o--X-----o--BB----Xo----o--M---X----o---?B---E--BBv
-----------M----?-----M---o-----o-E--?M--E-o-X-------?-o?----------?oo------?--o-----M--o--o-------X-------B----EM---------B--Mo?-------o----X?MM-o-X---Bo-BMB----o-E----M---X-o------o---o------M?----f
----------?--Mo--Xo-X-o---B----o----?-o?-M--o-----?----B---?-o--Boo--B?--------B----X-o----oo----XB----?-----------------M--B-ooo---B-o-??---o----??----o-?----X--BMXM?-----EE-o--o-M-----?o-o-?-----B-f
---------o--Xo?M-BM-MB----o---XM--o-----M-?X-?B------o--XMB------X-------o-o-X--o-M--B--o--BBM-?o---?---M----BE--X--o?---o-X---?X-o--?--o--M--oB-M--------------o----o-o-ooB??X-B?Moo-o--Mo--M------E--f
---M---o--o---o-----o---M?-o-BEo-E--EX-----?-----B??M?MBB-----?---BX-----XMM--M--?--Xo-------o-o-------?-----oBBX----oB---------XX----X-?-M--o-----o-M-E-M-o----E---M-M-------X?-------B--E-----?--XX--f
---o-----------o----B------?------?-B?-?------Bo---o---o--------M------o-?-----oX----?o-?------X---X-X--BM------B----Xo-------o-ooB---E-------------o----E-----?M---o-----?------B--o-----?XBE-E-?--B--f
-------o------o---o-o--X-?----------Xo--o---?---------X---------o---------------o-----------X------------o----------XT----------XX----M----------E-------?----------To----------X-----------oX?M-------f
m---o--------------------------------------X---o--------------o--------o-Mo-------------X-----------------X---X------|Xo-------------X---o-oX---X?-----------B?B?---|--------o---------------------X---X
XX-XX-X--XXXXXXXXXXX-XX-XXXX-XX-XXX-XXXXXX-XX-XXXXXXXX-XX-X-XXXXXX-XXXXXX-X-X-X-XXX-XXX-XXXXXXX-XXXXXXXXXX-X-XXXXXXXXXX-XXX-XXXX-X-XXXX--X--X--XXX-X--XX-X-X-XXX--XXXXXXXXXXXXX-XXXXX-XX-XXXXX-XXX-XX-XX
