o-------------------------------------------------------------------------------------------------------------------------------------------------------------------------------------------------------
?------------------------------------------------------------------------------------------------------------------------------------------------------------------------------------------------------|
|------------------------------------------------------------------------------------------------------------------------------------------------------------------------------------------------------T
?------------------------------------------------------------------------------------------------------------------------------------------------------------------------------------------------------|
X------------------------------------------------------------------------------------------------------------------------------------------------------------------------------------------------------o
E-o?E?B--Bo?-X--X?----?BBoB-M--M----o--?-B?--?o--BoMo?B-o?B-o-BB?M-BMXE-ooMEBo?----M-ME-MB-X?oBMMoMoMoB--?o-XMo-o-?-EoB-MMEX-?BMM?Mo?--Xo-MX-MBBoX-M?oX?M-BB?E?-Xo-oooMXoo-E-oBBo--MXB-oMo--oBo----o-BB?
??-??---o------o----o--------o?--oBo?---o--o----Xo?-?-oX---?o--------MX-Xo-B---MBB--M??M--oX-?---MoX-o-Bo-B??oo-M-ooBE----B-o------B-X?BB-oo-o-oB-o--MMo--o-M?-o---X-M-MoB?MoM--Xo-oX-o---X?--BEMM-?--oT
?--MXoo-MB---Mooo--oXB?-oXMM-B---X-?-M-oM--?---?oX-B--Bo-------o-MM---M?oB-o-o--o-?BoXBo--o?--B--oo--M--?-----M--EMooMM-o?M-X?-?--X------?-BBoE--Mo-o-o-T--o?---X-Xo----Moo-Mo-?X--oEX?o--B--o-B--XoBX?v
XM?-Mo-?---o?-Xo-o-XB--ooMooM--o-BB---B--o--o----X--?o-B-?--oo-Mo---?oo-o-X?BMMoo----|o?-?B-oM-B--Xo--oo--X-o--o-M-oX--MM-XM-o----oo------?---Xoo--MMBBB|MMM-o--B-M?---?-Xooo-M-?-MXXM-oX--oB?-M--M----T
B---o?M--o-o-oBMoooE-MX-X-o----oo---BX-E?B?X?-X?-MoB-?ooo-oXMBB-B-oM------?-----TEo-oX?-?--oo--oo??M-oMXX------X-o?---?--M--B-Xo-MX-?o-BX?o---?MXE?-----X--o?--X-X----B--?--ooo---oM----o?-B-o?-XBoo-o?-
?-BB---oM?BoBM-o-oMB-------?----XMo--o-X---?--o-B-M----?--?o---B-----o--o----o--|??-MBo----EX---B---?M--o-BoE?-?-B-o---?ooM-o-BMX-M?oBX-ooXoBo---X---M--o-B|o-oX---M---E---?-oXo-?X-B?MMo-B-X---B--o-|-|
|B-----M--o---oXoB-BB?-ooXoX-?--E-XMoo-o?BooB-M-o--BB?--o?--o---o-B-oM---XB?-BEEXX-M---X--oM-MoB-----o-?X--?X---o--B|-o-X---oo----o-?-o--X?ooBo-EoX-o-X-X--XXB--X-?-?BB?M?--oB??--?-----B---B-oE--M?--oM
-o-X--M--B-Moo?o--M-ooBBo-?EX--MBo?--B-X--------B??-----?---?o---Bo-M--oXo--?XM?-MM-Xo-?-??o--o----XB----ooX-o??-o--X-?-XM--X?B?B?B---Xo--oX--M?MMB--X---o?M-oB-----o-X----?o--o---------Eo-ooM?oo--MX-?
---EoEoo--Xoo----E---------BXXMB?o--o----o--Mo-o--o-X-oo------E------oo--Xo---oo--o-o---X-oXXo-ooo-------XTXo-o--X----oXo--o--------o---o----E----o?X---o---XX-o-oXX-o---XooX--o--EX---MXXBX-----o---o-E
m--MXB------oooB???--o-|oXoX-X--Xo-o--o-------oooo----o---ooXoM--oXoX------XXo-o--oX---o-oooXXooo-X--o-X-X|XX--o-oX-o--Xoooo-X---o---o-o--X--B----oXoX---o-Xo-X-oo-o-oo-ooX|-o---XMo-|BX?Mo-MBMM----o-||
XXXXXXXXXXXXXXXXXXXXXXXXXXXXXXXXXXXXXXXXXXXXXXXXXXXXXXXXXXXXXXXXXXXXXXXXXXXXXXXXXXXXXXXXXXXXXXXXXXXXXXXXXXXXXXXXXXXXXXXXXXXXXXXXXXXXXXXXXXXXXXXXXXXXXXXXXXXXXXXXXXXXXXXXXXXXXXXXXXXXXXXXXXXXXXXXXXXXXXXX
