|------------------------------------------------------------------------------------------------------------------------------------------------------------------------------------------------------o
X------------------------------------------------------------------------------------------------------------------------------------------------------------------------------------------------------X
?------------------------------------------------------------------------------------------------------------------------------------------------------------------------------------------------------B
E------------------------------------------------------------------------------------------------------------------------------------------------------------------------------------------------------M
B------------------------------------------------------------------------------------------------------------------------------------------------------------------------------------------------------T
XoB-B--B-Mo-o?-MMBM--M-oX-B-Xo-oo--BoBE?---Bo?-oM?--M?B?-----oo?B-B-M?B--oX-??M?ooo-Boo-?EoM-?-?BB--?Mo-XoBM-o-?--XXX-o-o?--ooMM??oo-?oX--XMXBo-o--?B---Boo-XoooB-X--Mo?B?-?o|-MoXoM-BM?MoB?-???B---oB-E
TB-o-?M---??M-E-----o--X-o--XM-X|-o-M-M-oEX-X-?---------o-?XooX----M------XB------Bo---?B?X---M---Xo---oBB--ooX-M?-Mo--MB-MoXB----M---o---X-B-?--??----o-Xo-X-Mo---M--B---M-MXB-BM--o----o--o----Eo|?-o-
---X----oM---BX---X?M?oB-MBMM---XBX---M-B?--oX-B--ooXXo-X|-o??------oB??-o--B-?------o-----BM-----o?M?B---o-------X-o-o--M-MM-BBo---???oX-?o---?X----B-Moo-oB---B------MX----?----M-X---M?---o-oMXXX-o-v
|--oB-----MMX-X-XXX---o-------B?--oM---o-X?BBoo--XMMM-B-BX-X--Moo--EB---?M-M-?--?-?-EXo--o----o--o-------?M-EooMB--o----B-X-------------?--?o?--?-o-X-o-?o-B-o----B-oM---?o?---M-X-XB--o---E---X-?XX?M-|
E?oB--o-MB--M-?o?----M----X-BX--o----Eoo-?---B-ooB-----o--ooX--M-MBX--o---o-B-------B??o-ooBXoX-MX-o-M-MX-BX?XX----oEMBB-Eo-Bo--?o-?M-Eo-|o-?-XX---BBE?--oB-B--oMX-oo--oo-X?--M--X-B-?-X--B?-o?-X-Eo---M
|-M----M-----B-M--?-?-X-X-----XoB--BBMB-B-??--M-M-XM-Mo---XXM-o-B--XooMBM--X-----MXMo--B--?--Xo---?---M-Xo--o---B--B?--M?M?B-?-------MM?-X-o-oX?o-B-M?---X---?X?----?XoBX---o--BoB-----BoM?Bo--o--MoB-B?
-?--BB--M-?oM-M--M------B-MXooMB--?----M----?o--------Bo---M-MM-----?X---o?XBB--?---?B--o--?-?X-----B--BM??oB--Bo?MBX-MM?BB----o-BX--M----Mo-B---o--?-X---X-?-B-o-BM-XB-o-M?XX?----B--o-B---XMMMX------M
M--M----------------o-X-----X---o---XoB-BoX--BM--BMBX--XEMB-o--EB--?-Bo-o--XB-oX-X-XoBo-XBB-T-o-MBoB-|-----B-?E-M?-B-M-XX-----?X--oo--M?BB-----o?XM-----o-X----XM?--o---M--M-XoBo-M-?oM---MM----oXoMMXMB
|E--BX-B-oo-?X-?-??-------oB-o-o---o-----?oX---oB---?XXB?--?--X?-??-?----o-B--?--oBB--X-----|??---o-oXo---?---M-----B-?oB-oo----B-B----X-oBBXB-B-o----Bo--------M?B?X-Bo-E--?---X--o--XXB---T?E??o?---B|
mX-X--?-o??--oo-oo--o-oBB---o--ooX-?o-X?B-BoXXoo--|X--o-??o-B---B----Xo-B?---oXXMM--oo-o?X-BX---??X---B-B?--?-o-o?X?-----o??-?-X-o--B|-Bo-----o--XMXMB-oXB-BB||XXM?--?-?B?X?-o?X?-?-Xo-Bo-X-|XM--o-X-?-o
XXXXXX--X--X-XXXXXXXXXX--XX-XXXXXXX-XXX--X-XXXXXXXXXXXXX--XX-XXX-XXXXXXX--XX-XXXX-XXXXXX-XX-X-XX--XXXX-X--XX-XXXX-X-XX-XXX--X-XX-XXX-XX-XXXXXXXXXXXXXXXXX-X--XXX-XX-X-XXXX---XXX-X-XXXX-XXXXX-XXXXXX--XX
