--------------------------------------------------------------------X----o-----------------------------------------------------------------------------------------------------------------M------------
----------------------------------------------------------------------------------------------------------------------------------------------------------M---------------------------------------------
--------------------------------------------------------------------------------------------------------------------------------------------------------------------------------------------------------
--------------------------------------------------------------------------------------------------o---------------------------------X-------------------------------------------------------------------
----------------------------------------------------------------X---------------------------------------------------------------------------------------------------------------------------------------
----?--oM-B-X--------X--?X?X-M--XTB---BX--X-MBo--MB---o--X---?XB-?B-X------?X---?-M?-MB-B------M-X-?------B???---------?-BMX--BX?---M-?--o?M-X-M--B-?-X----BMMX-B?-?-BX-M-------X--o-X?-?--?M---?---XBX-
-----X-BMX------MMBMXB----o-B-o-M|--XX-------oMo------BBBB----X-?--?----M-B--M---------B---BX-B-BX?-X?---------XXBM-B-X-------oX-?-Xo?o-?Bo-??M--M----M---?-o---oo--X--?-X-M-B-B-Bo--M-MoBM--B---o-B----
--------??--X?--o-----?--B-B-B?--X---M-?-?B--o-MB--?-X----------o----XXX-XooX-M-BBMX?-?--o---B---------MB-MM--MBX----M---B--MX--B--E--?XBo-----?-o-Bo?---X----?---MM-X-oX?M--oM-?o--M-X-Moo-XoB-M?M-MX?v
-XB?E-B-o------?-?B-------X------?--X---Mo-------M--??B---XX-BM-B-M--?----BX------o--B----?B---M--M-BM------X----MB---?--o-Mo-----M?----oB------B?--M-?B?-X----XX----------X----o----??X-?--M---o-o-oB-f
--o-?----?--BMX-----?-B-------------BMo-o----B-o-o-M--o-MM-o--------X--BM----?-------oM?------?--Bo-ooB??-?-M-M-----?---?-B--?-M---B-----------------oooo-------??--BX--B----?--?-M-?-----Xo--?--B-X-o-f
-?X-------B---X-----------M-?-----?---M-------M?----------XB---B--?---B-o-MM-oXM-?---B----B--M--Bo-----o---?-B-MXo--oM--------M----------MBX-MBM----XXX-B-M--M-X---X---?---XM-------o---?-BX-----oB--X-f
-o-X----??---M-B---o?X---X---B-o------o--X-M?--o-?-MMM-M--------B-o--B----o-M-XM---------Mo----X--B--M-?---o--M-?-----?M?-------o?---?M?----B---XB-XM---------?M-----M---X?B-----?-M-M-M-Mo---B---ooB--f
---M--M--------oX--?-X-----X--MM----B-EM-------------o--?X-XMM?----X-----------?-M?----?------B-----Mo?o-??----Bo-oo--------X?B?o---o-o-?B--oB----X--B-------------MX--BXB---XXo---o---oX----------M--Xf
---------X--T-----X-------X---oo-----XB-o------X------XX----------o----X-------o-o-----o----X--X---------------o---X------X--oo--X----------X-X-------X------------o-X-------XX-------E---Xoo----------f
m-----------|X--X----X----------------X--------X------X----XX--------X-X----XX------------X-------------------------X-----X-X----------------X----X-------X-----------------Xo----X-BX??-X-----------o-X
X-X--X-XXXX-X--X-X-XXX-XXXXX-XXX-X-XXXX-XXXX-XXXX--X-XXX-XX-XXX-X--XXXXXXXXX-XX-XX-XXX-XXX-X-X-X-XXXXXX--X-XX--X-X--XX--XX--XXXXX-XX--X--X-X-XXXXXXXXX--XoXXXXXX--XX-XXXXXX-XX--X-XX--XX-XXXX-X--XX--X-X
