----------------------------------------------------o--------------------------X--------------------------------------------------------------------M--------o------------------------------------------
-----------------------M-----o-------------------M----------M----------X-o---------------------------------o------------------------X-----------------------M-------M----o------------------------------
----o----------------------X--------------------------X---------------------------------------------------------M-----------------------o----------------o-------------M-o--------------------X---------
-----------------------X-----------------------------------------------oo--------------------------------------------------oo------------------X--------------------------------------------------------
----------M----------------------------------------------------------------M---------------------------------------------------------------------------------------------o----------------------------o-
----o-o---M-MX-?M?MoM??XTo?X?BMM-BM--XX-?----?-B-?-??-M?XB----XMo-?--M----?----?B?--MB--BX-M?M---XB?--X-BBX-?B-Xo?X-oX---B----?---M?------?X-B---X?X--?MMX--X--MXXM---Bo------BB--M-M-B-?-XB----X----MM-
---oM-Xoo-o--------Mo---|B-Bo-oM?-o--?o--BB--o?--oM--M-oT-----?-?--------B---?-ooo?---B----o-X-XB----B-B---B-oB----MB---B-Boo--Moo-------X----X?B--?E-o--MX----oX--Xo--B-?MBMXo--------?--?-?-----B?-o--
--?------o-M-?-XM---M--MXo--?Xoo-??-----Xoo---o--B-----X|X---------?--?-M------MM?-?----BXB---o--MMo--X--?--??-M----o----X-XBMM-MMXo-B-----o?-M--E---?Bo--MBXXB---oB----M-------Xo-M-----X-----o-B--?-Xv
-M--?-oXX----o-X---?-X---M?--X--E--M------oX?-o-B------oXX-BX?---X--X----?--BX----X-XXX------MM--o-BBXX??oX?-o---?-EMM-X----------?B------M----X?M?Xooo-oXooM--o-B-o-B-?--?-B---B-M-?---B--?----?-----Bf
---EoM----B?-XMM?-?-o-B--o--?XM??X---BXB--?--?----MX---XB-o---?-----o-M---B---MMXM--?-??-?-----?-XMo-----oo--M-BX--XooBM-----?--------XX-?-------X----B?MBo-oo-MM-??--?------M----o--?XMo?-X---B-?-MoXBf
--BX-o--Bo--MM--o--MB--o-----XoB-B?o-o?--?--M--MX?o-----oBMXX-----XMB--BXMo--?----X---o-Xo???-----oBo--E--B-----M?o-X-o-------B----MoBM------MM--------o--Bo----o?--X---?--?-------Bo-B--oB-B--------M-f
-o-B-B--oBX-----X------MB----XX----M---X--o--Bo---M---XMo-o-X---XB-o---o----?----M-----B-----?MX--X-XXXXoM---?XM--MXM---M?XX---o-----o---M---o--B----B?XXBB?-Bo-M-X-M-XM-X-M---------------BoM--Xo?o-o-f
---o--B---MX-----M---M-------X--o------B-MB----XMMM--M--?M-BXB----X---M-X??X---------MM----B?o---XM--oEM---M---o----o-X-B-----EB-E-B--BX--?-B-MM-XX-Eoo?----X---o?MB------?-B-EM-?B--M--------o---o---Bf
------------o----oX------M-oE--------X--oo-------o----------E-o----XT-o-----X----XoE-o---X-oo---oX---??o-----------------X-o--XXX?B--------E---o---XX-o-----------o------X-M-?M-----E-X------E--Xo-X---f
m--o------o-----------XXX-???M---oX-M-----M--X----o---o-o---MX-X--X-|----o-o-------X----X---oX-----o-------X---X--X-XX-----XX--X----oX--X-X?----X-X---X--oo------o---------o----o---o--------?-o-XX----X
X-XXX--XM-XXXXX-XXX-XXXX---XXXXXX-X-X-XX-XXXX-X-XXX-XXXXXXX--XX-XX-XXXX-X-X-XX--X-X-X-X-X--oX-XX-XXX-X-XXXXXX-X-XXXXXX-XXXXXXXX-XX-XXX-XX-XXXXXXX-XX-XXXXX-XXXXXXXXXXXX--XXXX---X--MXXXX--XX-XXXXXXXXXXX
