--------------------------------------------------------------------------------------------------------------------------------------------------------------------------X-----------------------------
--------------------------------------------------------------------------------------------------------------------------------------------------------------------------------------------------------
---------------------------------------------------------------------------------------------------------------------o----------------------------------------------------------------------------------
--------------------------------------------------------------------------------------------------------------------------------------------------------------------------------------------------------
----------------------------------------------------------------------------------o---------------------------------------------------------------------------------------------------------------------
---B-X-----X----MoE---?----?---ooB-------B--------?---M------o----B---B-------XXM-o-X--oM------?--X---X---ME---B---M-M-XX--o--o---BE-XBE?M-EB-Xo---oM-B----M--------o-----B-----EM-?---M?B--M--?-E---o--
------------?-M---B?-o--o------X-o-----X---BBB----o-B---o----B-?--o--M-oBM-XX-o----Xo-BX---------o---ooMooMX-------o----M-----X-X-??-o-B--------B------o---ooX--B--------M---------o?--o---o---MX?MM?---
---B--oo-----?o---M--------?X---?----X?M--B---M-----o--------o-o-----------------------------E--?X---?-oB---o-?----X----o----Bo---M-X-----?-------X-------BX-----M---------o------oB---oBX--o---o------v
------X-----o-B?X--B---?----o-----?----M--o---o------o--------o--o----o---o---oX-----X-o----EM-X-------o-o--B?-?X---B---M------ooM-------?-----oo---B------B-?M--o-XM-oooX--?-o-------------------oo---f
---Xo----oo---o----o------o-B---B?---Bo---B---M-------------Xoo-----o---??-o--------?X-----M?-oo--o-B------o--o--o---X--o-----?---B--M-----B--o---------Xo-------X-MoB-oX---oE--X-BB--X?-?-o---?-o----of
--------o---X?---Eo----o-B-M--M-------?o---o------------------Bo---?----o--MX-M?o--E--?------o---E?-ooo-----o--?M--M?-ooM----------------MMo-?B--?-----X-----------o----B?-?X?M-----?-B---o--o----o----f
---?--?---------?BX----X----------?-X?------?Eo--?--o------------oX---------o---XM-?--o----o--o----------------o------o----------X-X---Bo--o?------o-?-?-M----------oo--o-----oE-B-?o---o---oo---?---Mof
-----o--?-o---B----o----------X-----------?o-?---o---?X--B?-?X-o-oo----X-B--o---B-o-oM-------M-X-?----?-----?------X---------?-?-----------B-o---------o----X-o-?-o?----X----?-M-o----E-----XM----?---Bf
----------------o---o-----o--------------------------o----o-----------------X---o--X---X-o------E-------------o------o------oo-----------o------------------X---------o--o--------E-?MB----------------f
m---o------o---------o-o-o----------o-------o------oXo--o------X---------------oo--------X--XX--Xo---o---------------oX---o------------o----------o-------X-oo-------o--ooo-X-------------------o------X
XXXXXXXXXXXX--X--XXXXXXXXXXX--XX--XXX-XXXX-X-X-XXX--XX-X--XXX--XXXX-X-XXXXX--X--X-XX--XX-X-XXXXXXX-XXX--XXX--XXXXX---XX-XXXX-XXXXXXXXX-XXXX-XXX--XXXX-X-X-XXXX-X--XXXXXXXXXX-XXXX-X-X--XXXXXX-X-XX--X-XX
