----------------------o----------------M--------------------------------X--------------------M-----------------------------------------------------------------M--------------M--M----------------------
-------------------------------------------------------X----------M------------o-----------------------------------------------X---------X-----o-----------o--------X---oX-------X----------------------
------X----------------------------------X--X--------------------------------o------------------o--------------------------------------------o-M----o------o---------------X--------M-------------------
-------------------------------------------------o---------------------------o---------------------X--------------------------------------M-X------------------------------------------------o----------
---------------X--------------------o--------------M-----X----------------------------------M------------------------------------------M------------------------------------X-------------------------X-
---MX-------?X-?M?MEM??X---X?BMM-B---X--?---??-B-?X?X--?XB----XM--?-oM---MXo---?B?--XB-MBX-??M---XB?--M-BBX-oB-XM?X-oX---BX---?---M?-o------MB--MX?X--?MMX-Bo--M-X?---Xo------BB-XMoM-B-?-XB---MX----M--
------XX---------MBB-----B-B----?----?-M-BB---?---Mo-oBoT---X-?o?-----------o?o---o--XB---oo---X-----B-BoooB--o----MBX--B-B--M-X-E---?-?-X----X?B--?o-----M-BB-oXo-----M-?MoMX-----?---?--?-?------?--o-
--?E------oMo?-XM------M-o--?---o??-----X-----o--B---o-X|X------oo-?-X------X-XMM?-?----BXB-------M---X--?--??-Mo-oo-o----o-B-M--?XX-----?--?-M-o---B?BM---B--B----B---XMo----M-oX-------X-------B--o--v
-M-X?-MX----X--X---?-M---BX--X-Bo-oM-------XBBB-Bo?---XoXX-BX?---X--X---oo--B-------XXX-o-o--M------B-X?o-X?-X---?X??Xo--XM-o----B?----o--M------oT------X--M--o-B-----?--?XB-M-BoMoo---B--?-?-M?o-----f
---M-M----B--XMM?-?---MB-o?-?o-oB--o-B-M--?--------X---?BX---o------------BM-XMMX---?-??-?--X--?-X--o----?---M-B---M-M-M--o--?o-------X--?o-o----ooo--B?MB---M-MMo-?--?--M--MM----o-o?XM-?-----Bo?oMMXBf
-?M--o-?B---MM----oBB-o------XMM-M?-o-?o-?-?M--M?------o---MX-----XM---BXM-o-?----X---o-Xo-?o------M---o---o----XXo-X-o--X---M----X--BMB--Mo-MM--?X-o------o-----?--X--o?--?-o-----B--B---?-Bo----?--?-f
----oo---BX--o--X------?B-B----oo--M--oX?----B----X------XX-X----B----------?------o---B---o-?MX--X-XXXMMMB-X?XMX-MB--B--?-X-------------M----oMB---?B?-XBBB-BM-M-X-M-MBoX-----------------B-?-EX------f
-o--BoB---MX-----M---Xo------B---------B--B--o-XXM---M--?M-BXB-----oX-XoX-?----------MM-----?----XMMBX--o----o------?M-XB-----o--EXB--BX-oX-X-Mo-XX---o?----X--Xo?MB--oo--?-B--MM-Bo-M---------B----o-Bf
----o-o---o---M------o-o---o-o---X---X------------------o---Eo---T--T-X--oo--o---X-------o-------X--------X--o-----------X--X-X-BB-------o-----o-o-oT----------o--------oo-------M-X--BX-----E---X-----f
m------------o--------X------X-----oX--------X-------------MMX-X-|X-|-o--o--------o-----X---XX-o----o------X------X--X----MXX--X-----X---o------X-X-|-----o-----------------------Xo-------MXM?--X-----X
XX-XXXX-XX-X-XX-XXXXX-XXX-XXXXXX-XXX-XXX-XXX-XXXXX--XXXX--XXXXX-XX-XXX-XXoX-X-XXXXXXXX--XXXoXXX-XXXX-XXXXXX--XXX--XX--X-X--XXXX-X-oX-X-X-XX-XXXXX--XXXX-XoXXXXXXX--XXX-X--XX--XXXXXX-X---XX--X-XMXXXX--X
