-------------------------o---------------------------------------------------o------------------------------o-------------------------------------------------------------------------------------------
----------------------------------------------------------------------------------------------o------------------------o-------------------------------------------------o------------------------------
-----------------------------------------------------------------------------o-----------------------o----o----------------------------o---------o----------o-------------------------------------------
------------------------------o-----------o--------o-o-------------------------o-----------------------------------------------------o------------------------------o---------------------------o-------
------o-------------------o---------------o-----------o---o-----------o------------------------------------------------------------o------o----------------------------o--------------------------------
-----oXBEoX-XB-----oE-------X---oX-?------B------E-oX----E---B-B-----??--E-------Xo---M------B-?M-X-B--B--o--EE--?XB--?-o?M----XMo----o--B??-B--X?oo?--?-oMM-BB----M-E-E--E-o----Mo-?-?-o--XEE-B-X-B----
--o-oMM---E--------E?-B--Bo--?X?---oM---XEM----XMo?-X-XM-B-EBE-?--?M---EM-----o--X-EMXB-------B---E-o---oM----B----EMXM-E-XB-------?------B---E?--?-EX----B--EooE---B------M-X-XXo---E?o--ME---BMo-B----
--o--oM---B-oM-BBMX--X-o?o--E-------Xo-?B?X-X-------XMM----BE--oMEX-?------------E----?E---o-B--E-----M-B---E--------X-B---M?M-M---E-X?ooo---M-----E--Eo--E--Xo-?E??o-o--E-E--EoXE-o------E----?B------v
--?----o-X-----EB-----?--o-X-M--o---?--M-BB-------M-E------XEooX-M---o--o--oB-EXo--ooB?EMo--o-?o-----Xo-?------MM-------o--o----o-?-o--Mo--MX-M--oX-o-EMXX-M----BoE-E---M---?B-----XMX-BE?E--BM--oo--o-f
---o?M--?B-----E-MoEoB-?--M-----Mo?Eo?-M-B-MEM----E-----?BX--B-M--o----M---oo--------B-Xo---M--B-?M-M--X---XX-XE-MM-?-EM--X-E---??------B-M-E---X-E--oX--oo--o-o----E-oMXEX-MMo-Bo-?----?X---Eo--?---?-f
----o-X?-M--Bo-?-E-B---M----M-----o-----M--?-o---?--E-o--B-M---X-E--X-----EM--XMo---X-?-EBE-BM-?---oE----M--?--Eo?---M-B-?----BBE-Eo----?-----M--?-----?--o-E-X-B-----E--?E-o--M-?M---Eoo-----X----?---f
------?B--oE--?-oB--ooo-oBooE---MBX--------XXM-BB--o------E?B----o-M---M-B--E-oMMB-Xo----o--M---o-----------EoM--E------E-?EM-XE----?-M--EX---M------MMX-----X-----B-B--MMoB------------E-------XX-Xo--f
---o-M-M---M-E?--o--M------o---?-BoX-X-o-oo?o-EM-MEBB--EE-----XX---BB-MBEoBBX--------X---oo--o----o----X----MX-?---X-------oM----o-----?----EE-?-Xoo--?--E--oX--o--X---oXo--M-X--o-?--E---M--EE-oEo----f
-------o?--?--E----B--X?--oEX?E--?-----oo---oXoo---X-oBoEB--E?---Xoo-----XX-??-------B---X-E---?----oB-------oo----o--o-------------Eoo-X-------X-BB-o?X-----o-o-o--X-?--X-B---o?-----X-o-X-XX?-BoX-Xo-f
m--------o------E----o------XEX-E--BEo----o?----E-BB-?---X--oo--oX?-X------EE------?E---oXo--EX------BEB---oo--XXEo---E----B---?----X------X-?----B-oXoo-?-----B-------XX------o-X-o-?-BE?B--E-BE-BX---X
XXXXXXXXXXXXXXXXXXXXXXXXXXXXXXXXXXXXXXXXXXXXXXXXXXXXXXXXXXXXXXXXXXXXXXXXXXXXXXXXXXXXXXXXXXXXXXXXXXXXXXXXXXXXXXXXXXXXXXXXXXXXXXXXXXXXXXXXXXXXXXXXXXXXXXXXXXXXXXXXXXXXXXXXXXXXXXXXXXXXXXXXXXXXXXXXXXXXXXXX
