T-------------------------------------------------------------------------------------------------------------------------------------------------------------------------------------------------------
X------------------------------------------------------------------------------------------------------------------------------------------------------------------------------------------------------?
M------------------------------------------------------------------------------------------------------------------------------------------------------------------------------------------------------?
X------------------------------------------------------------------------------------------------------------------------------------------------------------------------------------------------------|
|------------------------------------------------------------------------------------------------------------------------------------------------------------------------------------------------------B
XBo-?-?E-M-BB-oM?M-BMXB-B---?Mo----?o?MB?--oBMXEoXo-MoB?o?XB-B--E-o-M-X?-o-B?B-?T-XBB-BME-oX-M-XXoM?E?o-XMoBB-o?M-XB-o-M-?-MBoB?Bo-XB-----?o?--M-M-BoMoBo?BXoo-X-M--BXo-Xo?B???-X----?o-?-B?B-M?Mo--MM-T
-----?M?X----o----?--E-B--M?--?X-oB-M----o-X--MX---M-o--M-M-o-?BBX-o-----ME-----|o---B-XB-XB--oM?-XXX--o--o--M---oo-o-?---o--X---X?o--o?E--B--o---o-?-o-?--oM??-M----XB--X-----BBB-oM-?B---------?-M--?T
M--B---X--Xo-EM-Xo--B?o-----Eo-oo--X-o---X-EB-B?o?o--M---o-oB---o-MBoMMBB?BBBB--XMXM?-oMBE--?BB-----|?o?o-o-?-XoM-Xo?---o-BBE-o------BM??M----XB-----B-----o---o--MB---EXXo--o----M?----X?M--oo---M-M--v
M----o-M--oBMB-o?M-o?BX-BoXXM-o-M--oXB-BoX-X----------BB-?B----MB?--o---BBoX--?-o-X--??-XX-o-----o--X-o---BB--BX-oMo-?-Boo--MX?-XB-oo-M-M-X-oMo-M-oBX-?B-BXM?--Xo----o-MMo-X-?---X--BoE----?-MoX-?-M-Xo|
MMBBMo----B---X----?-----oo-M-BX---?--M-MM-o-Bo-B?--?---B---o-o-?M-----X--X-EB---oX------Mo?-??B--B----o-----o---?-X-----o-BMo-Bo------o-?--E----Eo-oM----B---oo---M-XBM-?-o---MM---?B?-oXo-o-oX------E|
B??o?--E?M---Bo------ooo-??--o-MMoo-M--B---o--Bo--?--B-X-?--B-M---o-X?-M--MBM--X--B-oB-B--o-X---XX----X-X-X--XBBo-XMMMBoEB?--B-----??-BXB-MXBMM?X?-oM---Mo--X-MM----B-----oXBM-----Bo----MB--EoM--oX?MXX
M--M-MM?----o-Mo?o-BMMXXo----M---MM?------?-M--MB---T--BX-oo-o-BoBBXB-o-M-M-o--?Mo----B----X?B--E---EB-XX?-------?o----?M--o--?o-oo----o--E-----X?B---XM-M---M--o-?---??o-M------oo-?-MB?--oXBo--X?B?-oX
Xo----?B?--M-M-M-oM---B?BXBo--o?--o-B-?o---------?BX|MX--Bo-BB--MB-B--M--?--Xoo----oo-----oB---?B-BM?---B-BB-?EXX-B--XX-X--XEM-BMBXM-?-?X-B--o--o--M--o---oBB-MX-----o--X--B-----?M--M----M--BXXXX---o?T
TB--------X-T---X--o-------BB-?--o---B-o--o-X---o--?X-X-B-oX---B--o-?---B--XEXo---oBBX-EE-B---X-oX-oXo-?------M-?--?-X?X--XBM-------?---o-|?-?X?X-E--o--X-X----------?-Bo----Xo-o--?--B-X--oB-XXEX---T-M
m-oBo-o?X?XX|o?Xo?-ooX-oB-o--o--|B|Bo--X-XXBoo--BoB-X------B-oo-o----o-?---?M-?--XB---???o-X|o-o-?-oXoo--|o?|?o--X?-BB--X-B-B--o--o--?o?oBX-o-B-?BM--X---o-M--o-o-X-B-o-B-B?o?--X??-BB-oo--o-XXX?Booo?XM
X-X-XXX-XXXXXX-XX-XXXXXX-XXXXXXXX-X-XXXXXXX-XXXX-X--XXXXX-X-XXXXXXXXXXX--XXXXX-XXX-X-XXXXXXXXXXXX-XXXXX-XXX-X-XXXX-X---XXX-X-XXXXXX-X-X-X-XXXX----X-XXXXXXXX-XXXXXXX--XX-X--X-XXX--X--XXXXXXXXXXXXXXXXXX
