--------------------------------------------------------------------------------------------------------------------------------------------------------------------------------------------------------
--------------------------------------------------------------------------------------------------------------------------------------------------------------------------------------------------------
--------------------------------------------------------------------------------------------------------------------------------------------------------------------------------------------------------
--------------------------------------------------------------------------------------------------------------------------------------------------------------------------------------------------------
--------------------------------------------------------------------------------------------------------------------------------------------------------------------------------------------------------
--XMBMBT--B?XMBXX-??ME---?MX-M?---MB-MM---X--X---M-?M----?-BX------TM-o------?X?-----MMM----B-------Xo--?----X----?M?B-X--BM-XXM-B--?BX-MM-M?--M-----M-?---MB-XB-o-X-B-MM--?X-o-B-oMBBB--B-o-ME-o-X-E---
-------|-X-----X-?--?M-??--?-o--B---B--?-M--M--X--X--MXMo-M--MM--?-|--?----?------X---o-X-?---XB?-M-?B---B--X-MXX-----B?B-o-XXoo?-X-o-B---X--?o-TBM-B--o?-X------XXMM-M--B?oB?----?--ooBB-MXBMXXM-oBM---
-B-o?M-X?MMX--oBMo?---?o--M--XM---?--?-------BM--X----MoX-oMBo-?--?X-----M?-?-------XM--M--BM----X---o--------o--Bo?-----ooX-MBM---E----??X---o-|o---X-o--EM-?----X--?----oX-o-B------?----o-B----X-?XMv
-o?---B------B-----B-----o-oE--XX-------B-----------?---BX-o--?--?-M-X-M-o-X-------M---?-oXo-------X--X---B--BX-M-------B??BM-o-??MXX-oo---X---?X-----XBXMX-Moo-oXX----oB--X?B--?XMX?---?--BB-------o--f
--o-MX-----B--------X-M---?-X---??-?------B-----??B-o--X--M------oo--?--B--B-BM-oM----M--?-?B---?-??M--M----M----X--?----o-------B--?--X--BX------M-X-X-B--X--MBM-B--XMB-?-M--?X-----M--o--o---M-o---?-f
---B----X---BB-B--?-T--X?M-X--?X-----------X-----------o-----M?---M---XM--?o---MX-XB---X-----?X-------M-MB-B--XX--Xo-----B-----------X?-?X-B-?oXo-oMoB-------o---B-----X--X--X-X-X?X---MB---?--oM--o---f
-----oXMB---oo---M--|X----MBBBo-X--?X------MX-B-----?MBBXM-----XBB-?--?--?--o-------Bo--?M-?B--?-?XE--o-----B----E-??XB?M----B---X?MX--o--?o--B-BXooB----B---?---------X-MB--------B?------o-o?XooXM---f
-?-X?Xo---?-oo-BX---X?---oo----X-----Mo--------M---?-o-o---X?X-M--X--Bo----BX-?-B----?----B-o-X---??-X-BM--X--?-MB?-----o-?MXo-B-X----o?-Mo----X--?B--??M-E--o?-?--X--B----X----M?---M--E--?-B-XEBX-X-Bf
-----------X----XX--X-----o---E---X---X-oX-------X--T---o----o-o-oT-X-X--------------oX---o-X-E-----------------E-------------------------X--X---o-------X?--------------o---X---------o?--oX---o-X-o--f
mo-oX----------X-X--------o-o-M---------X--------o--|---XooX-X----|--o-----------X-X--X-----o-M-o-o-------XX--MBBM-------------------X--------X------o-o-Xo-------X-o----Mo------o-X----o----X---------X
X--XXXXXXXXXXXXXX-XXXXX-XXXX-XX-X-X-XXX-XXXXXXXX--X-XXX-XXX-XXXXXXXXX-XX--X-XX--XXXXXXXXX-XXXXXXX-XXXXX-X-XXXXX-XX-XX--XXXX--XXXX--X-X--X--XXXX--XX-XXX-XXXXX--X-XXX-XX-XXX--XXXXXXX-XXXX-XX-XXXX-XXXXXX
