?-------------------------------------------------------------------------------------------------------------------------------------------------------------------------------------------------------
?------------------------------------------------------------------------------------------------------------------------------------------------------------------------------------------------------?
X------------------------------------------------------------------------------------------------------------------------------------------------------------------------------------------------------|
X------------------------------------------------------------------------------------------------------------------------------------------------------------------------------------------------------X
E-------------------------------------------------------------------------------------------------------------------------------------------------------------------------------------------------------
E-X--XE?oME?MXo-oo-X?EE--?XoooX-?M?Mo----Xo?-oMo--?XMX-?E?MXEB--EMEMB-E-EMXBBBX-----E?o--BM-EB-Bo--B?-BE?M-XMBMoEXMo?X-XXEXo-XBoEooX-E-o--X-MEM-BXBM--M-oX?-E-M-X-M-BM-EEXo-oo?XoXEXoo-M?o-oooEoMMoBoB-o
TMMBM--?BXMBEooXB-?-??X?-BoBBB??----oEEXM-oo--MXB--EMX----oBoM-MBB-?--E-??oo--oo-B-B?Moo?X?-----o---EoB---MEXEEooEoE----oo-Mo--B?X-oM--X-BMM?XXEoME-E?-o---?oE-Mo-BBE--o?M---BM-o?XMEo?-M--EX-Mo-E-Xo--?
--o-XEo--o-?oo?BoXo??Eo?-?M-XEMME--B-?X--Bo-oBBB?EX?MMBEB?Eo?E?---?MXM-XXXoXEMB--o---Moo--o-o-MEE-EoXMX-X??BBEXBM--EM?--o-B?M-X-MBB---o?oo?B-o-M?E--BMB?oM-X--EXB??B-MMX-BE-E?oX------X-X-oM??BoEMXMoB-v
?BoBEXMBB-BX-X-oXo---ooMM--EoB-oXX---BMB-B-BX-M-???MXXEoEB-??--MEooMEMB-?E-M?X?o--oM-o--MBoXBM?BoMB---BEEoo---BBBo---BX-o-B-?Bo--oEo-X--o---?-X-EMB?MM--?-oBEM----XoEX-MEM--B-XooEBMBB-?oBBX-?X-B-ME-XX-
|ooBEEM-MEMM-?B----M?-oM?-oBMXB-?-B-B?o?EoE-o--XM?-oo-?-E-B--EBEo?-?o-oBB-oXo?MXo-MXXXBM-oX?-E?-o?M-Mo--oEE?o-o-ooM-o-?BEXX--B-EX-o-ooE?oE-X-EooBB-??-EBB?-MoEoB-X----XM-Mo-B---?MMX-B-BoE?M?-E---?BMB-M
EB--oBBXoX-BM?---EXoMo--BB-?XoB-X--X---XEoXEX--MoooE-B?-E?-BMBEX-XoMX?oEB-Xo---ME--EBXXM-B-MX-?XoX---o?B--XEX-EXB-o-?E---MB?Xo?X----B-XX-XM-E?EXX-o-?M?BXo-BMEEo-EMMEo-M-?EBoBoo-ME-B-?MoBEXMEo-?E-EX-B-
?--X-BBXEMo----?--oBoXMooo?-MBBEoMB??-oBEMBB?-M?XEoEoBBBEEBEE?BM?E----?MME-EMoBMo?MX--?B-B---EoM-BXMXXEMoEEEEoX--ME?B--?EEE-X-?--oX-XXo-B-MBXB--B--oo-M--oEXBE--ooXMoooo-BEoEEXXMMMooME-o-M--EX-BBo-BMXB
MXB-?oBB-oM-EooB-XX-oXXEBE?Xoo-B--Bo-BEX-oMB---o-?ooo--oB-X???o-?M--Boo-BoBoXM--BMXBE?-XEXBMM?o-Xo-ME--XB-?M?X-BoMoMo?-Xo-M?Mo-M?-oMXEoooEEMX?B----oMo?BEE-?-X-?oMB-BBE-?o-XoX-Xo?MXX-EB-MBMEEBXM--BEBEo
X--oEBB-E--?-X?X-X-B-BoXBXBBX-oXX---oooXoXXB---EBooo-BB?oB?-oXo-XB-?--oo?o--oB-XoX---B?XXX-Bo--o-EEo-o----E--oo-X-Bo?E?---oo---XoEBB-Bo-oEEBBB-X-??-X?EXB---oEB----o--???-ooBBX-?EoXoBo--?Bo?---Bo-X-o--
m-E?ooE-B?X?BEX--?----?-?X-B---?--?oXB----BX--B?X-oEoo--EE-B-BoB---E-----XE--oo---XX-XXBB--?-o-E--B--?X-?---o-X-?X??--o-Boo----B?-X-EX-E---o-??oEBXX-oB--B-BE--E-XoEX-X-X-o-?B-?----oX-oo?X-E??B--B?-BoT
XXXXXXXXXXXXXXXXXXXXXXXXXXXXXXXXXXXXXXXXXXXXXXXXXXXXXXXXXXXXXXXXXXXXXXXXXXXXXXXXXXXXXXXXXXXXXXXXXXXXXXXXXXXXXXXXXXXXXXXXXXXXXXXXXXXXXXXXXXXXXXXXXXXXXXXXXXXXXXXXXXXXXXXXXXXXXXXXXXXXXXXXXXXXXXXXXXXXXXXX
