---------------------------------------------------------------------------------------------------------------------------M-------o---------------------------------------------------X----------------
-------------------------------------------------------------------------------------------------------------------------------------------------------------------------------------------------X-o----
------------------o-------------------------------------------------------------------------------------------------------------------------------------------------------------------------------------
---------------------------------------------------------------------------------------------------------------------o----------------------------------------------------------------------------------
-M-----------------------------------------X----------------------------------------------------------------------------o-------------------------------------------------------------------------------
----?-o-M-B-o--------X--?M?B-M--XTB---BX----MB---MB------X---?XB-?B-X------?X---?M-?-MB-B------B-X-?------B???-----B-?-?-BMM--BX?---M-?---?M-X-M--BX?-X----BMMX-X?-?-BX-M-------X--?-X?-?--?M---?---XBX-
-----MBB-XoM----MMBMXB---o--Bo--M|o-XX--------?X-------?B--X--XoX--?----M-Bo-?-------o-B---BX-BoBX?-X?------o--XXBMoB-X-------oX---X-?--X---??M--M----M---?-o----o--Xo-?-X-MMB-B-B---MoM-BM--B----XB----
-----oo-X-M--?-------o?-oB-BoB?--X-X-M-?-?B--o-?B----X-------------o-XXX-X---------X?o?----o-B-------o-MB-MM-?MBX-o--M---B--MX--B-----MBo-o----?---BX?---X----o---MM-X-oX?Mo-oM-?---M-X-M---X-B-MX--MX?v
-XBBo-B-o-o--o-?-?B--------------?-BX-X-M-o-MX--oM-X--M-----oBo---?-o?----BX--------------?B-o-M--M-XMM-X--------MB---oB---M------B------B------B?X-M-?B?o--?B-Xo----------X--o------?-X-?--Moo------B-f
----B----?--BMX-M---?-B-X--B--------Bo-------M---o-Mo---M----o------X--BM----?------X--?------?--o-M--oXBB--M-M---o-?---?-BoM?-M---B-----o------o------------o--??---X--B----?--B---?--?-oXB-BB--B-X---f
-?Xo-----oBM--X-----------M-?-----?---o-------X?---------o-BB--B--?---B---MM--XM-?---B----B-oM--B------M---?-B--X----M----o---M-o--------MBX-MBMo---X-B-B-M?-M-X---Xo---o--XM-o-oX?---MoXMB-X-----B--X-f
---X----??-----B---X?X--BX--oB------ooX--X-M?----?-MMM-M--------B--o-Bo-----M-X----------Mo-T--X--B-MM-?------M-?BM---?M?-----o-BX----M?----Bo-o-B--M---oo-o--?M-----M---X?Bo-X-??-M-M-??-----B-----B--f
---M--M----?----X--?-X-----X--B--X---M-M-------X----o---?X-XMM?----X-----------?-M?----?----|-B--o--o-?oX??---oB------o-o---X?B-----M---?----B---oX--B---o---------MX-MMXX-------o----X------------M--Xf
---o--------T-----X-------X----o----X-X--------X------XX---------------X-------------X-o--o-X----X-----------------X-------X---ooX--o---------X-------X--------------------oX-X-----------o--------o---f
m-----------|X--o----X---------o------XX-------X-----XX----XX--o-----X-X----XX------------M--X-X--------------------X-----X-----X-----X------X----X-------X-----------------X---X-X--o---X-------------X
X--XX-XXX-X-XXXXX--XX-XXXX--X--XX-XXXXXXXXXXX--XXX-X-XXXXX-X-XXX-XXX-X--X-XXXXX-X--X-XXXoXX-XXXXXXX--XX-XMX-XXXXXX-XXXXX-XXXXXX-X-XXXXXX--X-XXXXXXX-XXXX-XXXXXXX--XX--XX-X-X--XX-XXXXX--X--XX-X-XX--XX-X
