X------------------------------------------------------------------------------------------------------------------------------------------------------------------------------------------------------X
B------------------------------------------------------------------------------------------------------------------------------------------------------------------------------------------------------|
|------------------------------------------------------------------------------------------------------------------------------------------------------------------------------------------------------B
T------------------------------------------------------------------------------------------------------------------------------------------------------------------------------------------------------|
E------------------------------------------------------------------------------------------------------------------------------------------------------------------------------------------------------o
B-Eooo--XM---?Mo--M??o--oo?o-o---E-ooo----o-?oXT----?-Bo-o--o--B--Xo--oMo-B-----M-oX---oM-----Bo-B--o-o--?----o-o--M---oo-o----o?--ooBX-------M-oooo--oMoB--X--o----Bo?o-oo-oo-?-oo-o?--oo-----X--oooo?|
MoB-----o-o-o-----oo-B-----X-o---M---MME-oo-o--|-o--o-----o-X-?-o-oo------oo-----oo-----o-------o-o-o--o------X-M-o----MX-o---o-o-o-----o---oo---B--oo---o----o--o-o-o-X-o?-B-----o---o--Boo-----------X
?o----o-----XX-o-o--oo-----?-M-?X---o---o--B---X-?--o----o-----oo---o---Xo-----o--o-o-o-----o-M--ooo---o----o--o--o-o-B-o-o--o---ooo---o-o----o?-o---o-o-----o----------------B-o---?----o--?-o------o-v
M-o----o-o--o-o-------o---o-o-----M-X-oo-o--------X---------o--o-----------oo----o-ooo-------o---B-B---o--oo---o-Xoo------?oo--o-o-M-ooB---?------o---o----oo----o---o--o-----ooo--?---BXM---o---oo--M-M
T--Moo-B----Xo--Xo----X-Mo---X-o--o-Bo-B---o---oo-?--o-----o--o----o--------o--B--BoMo--BB--------o-B---o--M--o-oo--o-----o-MM--M---o---oo--o---o--o-?----X--o-------oX-M-o---o--o---------oXooo---o---B
B--o-o-o---oo--------Xo-o--o--X--oo---o-o-o?-M-oB?-----o--o--ooX--oo--X-------o-o--o----o--o-B-o------o-----oo---------o--XB--ooo-o-o----M-----o---o--o-o--oo-?-o--E---o-oo-o-B----o-o----oM---oX-o-----
?-o-----o-oo---o--------o-------o---------o-o-------Mo-o----o--o---o----oo-oMo-----o--o--o-?---o----o----EM-X-------oM----o----o-E---B--o-o------M---o-o-o---o-ooBBBB?-o-oM----oo-?-o--o-Bo-oooMo-o-o--M
Bo-o--o-o------?--oo-----o-B-----oo-o-------M---o-?B---X------oo-----o----o--o-ooE------o-oo-o------?--?B?-o-----o-----o--o--------?-o---B--o-o--oo--o-o--o---X--?o-o-o-?oo----o---X---oM-o--o-------M-?
----o--------oo--o-o-oo-o---o----o------o-o----X--o-oEo--------o---------E-----MMX?---------o------o------o----oo-o---------------oo-------X--o-------o-----------oo-o--o-o--Xoo------o----o-oE--------B
m-o-------o---o-o----X--o------o--o--X---------o--oBMMX-o--X-o-------o---M---oo--o-o-oo--o-oo-oo--o-oo---------o--oo----------ooo-o--o---oo-o--o-oo--o----oo-----o-----ooo--oooo-o-o-oo-o--oo-Xo-o-Xo-oB
XXXXXXXXXXXXXXXXXXXXXXXXXXXXXXXXXXXXXXXXXXXXXXXXXXXXXXXXXXXXXXXXXXXXXXXXXXXXXXXXXXXXXXXXXXXXXXXXXXXXXXXXXXXXXXXXXXXXXXXXXXXXXXXXXXXXXXXXXXXXXXXXXXXXXXXXXXXXXXXXXXXXXXXXXXXXXXXXXXXXXXXXXXXXXXXXXXXXXXXX
