?------------------------------------------------------------------------------------------------------------------------------------------------------------------------------------------------------o
-------------------------------------------------------------------------------------------------------------------------------------------------------------------------------------------------------|
o-------------------------------------------------------------------------------------------------------------------------------------------------------------------------------------------------------
-------------------------------------------------------------------------------------------------------------------------------------------------------------------------------------------------------|
T------------------------------------------------------------------------------------------------------------------------------------------------------------------------------------------------------E
M-oMB-----o--oM-Bo----B-?oo?M-M-MXoo--B-?---?-B?----M???X?-o---oMMXBoooMXXB-?o--o-oB-Mo----B?o-oB-?X-ooooo--M--BX--B--X--o-BX-ooo?-ooM--E-M?-o-M-??MX--o-Boo?o-ooXM-oBX--?-?-XoM-o-o?-ooMMBB-oo-o?ooo-MT
oo-----BM-X?XX-o-XM--B-o-B?--X---X-XB-o--B-B-Mo-oo?-----?--B--B?--o-XBo-B-oB-B??-BB-?oM-XM-----?-o-?-BMMoX--o-?--------?BM?--oMM-o-?MoMBMB--o-?-Moo-o--BM-BXoMoMBM-oM-o-X-o--oX-MMM?-XM?-o---BoMM--MBX-E
XMEo--?-----XB-o-ooM-o-??-o-oM-oo?o-o--MB-B-X---o-o--?oX-M---X----Xoo-?oo-------oo---B-o--X---o--XB-o---oMX----Mo-?-M?-o-o--o---?-----M--o-M---M-oM-?M-o-o-X--Xo----o-?--M--XBo-----Xoo-B---o----?o--?-v
T?B-----Xo--B---o-o-oX-o-?BM---B----o----o-M?oo-MM-M--MX----Eo---?-oM--M--?E--o-Mo-oB-o-?oXM-X??---oX-B-?-B---M-X-oB--o-o---BB-B-??----?XX---X--oo-o--o--oooooMoM?o--Bo?X-M-X---X-o?-?Mo-E-BBBo-----Bo-?
T-MBM---o---oMXooooMB-??--ooB----??-MB-------M?o-o-o---XB?-XBEX?o-oX-X---XXMM?MX-MMMo--ooM?-Bo--?oo-o----M---o--oB?--MB-M-oM-------MX?M-oM--MoX--B?-MB??ooo-o?-o--?MB---oo--M--B--o-o--oX?Mo--B--oM-oo-o
oo---BoXMo----oM---o-o-oo--o--oMM--X---?X--BM----o---oo?--oBBBXo?-o-o-X-oo---o------MMo?---oo-o---Bo-M-B-o-oooo-Bo--o--MoBM------o--B--?--X--M?-Mo-o-o--BBB-?oooo?---B-oBM---B---Xoo--B----MB--?B--X?--M
oM-MX-BB-?-B?oB-oX-M-X--?-M?--B--o-Bo-o------MMBMX-o?B?-oM?o?-oM--MMMoo-MBX-B?MMXBoo--B-?B-BM-o-?--M--?-?--?X--X-X--B-o------M---MoB-o--oXB----M--oo-XoB-----Boo---M---B----?oooX--oooo--o-------X-B-??X
M-M---?----o-Xo--X--M---oo-----B-M---ooo-o?-o------------o----M-o----MBM---?------X--Mo-----o|?X-oo--ooM-o--MXo---X-----MBX--oX---M-oo?-X--X----MoM-Moo-B------MX-oEB-E--X--o-X-MM--?o-X-Xo---o-o-X----T
----o-o--E-o-o--ooo-------------X---EX-Xo---oo------o------XoX--oo------o----o-To-X----oo---XX-------Xo--o---Xo-----XXo---o--E------X---o--X--o----o-oX-------o----?-oX-o------X----o-ooX-E---X--------E
m--ooX---XoXoo----ooo--o-Xo---X--oXM??o-Xo-o-X----o-oo------o---X----o---oo-oo-|o|----ooo-o-o-oo---oXX--o--o--X---o-oo-o-ooXXM-o--oo----o-oo--o-ooo-o-o--X-o-----X---o----o-oooX--oo---oXXBoo---oo-oXo-?
XXXXXXXXXXXXXXXXXXXXXXXXXXXXXXXXXXXXXXXXXXXXXXXXXXXXXXXXXXXXXXXXXXXXXXXXXXXXXXXXXXXXXXXXXXXXXXXXXXXXXXXXXXXXXXXXXXXXXXXXXXXXXXXXXXXXXXXXXXXXXXXXXXXXXXXXXXXXXXXXXXXXXXXXXXXXXXXXXXXXXXXXXXXXXXXXXXXXXXXX
