--------------------------------------------------------------------------------------------------------------------------------------------------------------------------------------------------------
--------------------------------------------------------------------------------------------------------------------------------------------------------------------------------------------------------
--------------------------------------------------------------------------------------------------------------------------------------------------------------------------------------------------------
--------------------------------------------------------------------------------------------------------------------------------------------------------------------------------------------------------
--------------------------------------------------------------------------------------------------------------------------------------------------------------------------------------------------------
--XMBMBT--B?XMBXX-??M----?MX-M?---MB-MM---X--X---M-?M----?-BX------TM--------?X?-----MMM----B-------X---?----X----?M?B-X--BM-XXM-B--?BX-MM-M?-oM-----M-?---MB-XB---X-B-MM--?X---B--MBBB--B---M----X-o---
----o-o|-X-----X-?-----??--?--o-B--oBo-?-M--M--X--X--MXM--M--MMoo?-|--?----?------X---o-X-?---XB?-B-MB---B--X-MXX--o-oB?B-o-XXo-?-X---B---X--XXoTBM-BoE-?-X-----?-XMM-M--B?-B?--------oBB-MXM--?M-o??M--
-B--?M-X?MMX---BM-?---?---M--XM---?--?-------BM--X----M-X--MB--?--?X-----M?-?-----o-XM--M--BM----X--oo-----------B-?----o-oX-X?M------oX-?X-----|---?BM?--oM-?----Xo-?----oX---B------?------BX-ooX---Mv
-o??-oB--o---B?o--oBo-oB----o-oXX-------------------BB--BX-oo-?--?-M-X-M---X-------M---?--X-------oX--Xo--B--BX-Mo--B---?-XBM?--?-M-o---?-oX-o-?X--E---XX-M-M--o-XX--o--B--X?B--?XMX?-oB?--BB--ooMX----f
----MX----oB--------X-M---?-M---??-?------B-----??Bo---X--M-------o--?-oB--B-BM-oMo---M--?-?B---?-??M--M--o-M----X--------------oB--?--X--BX---o-oB-X-X-B--X--M?M-B-oBX--?-M--?Xo----M---o-----M-----?-f
---B----X---BBoB--?-T--X?M-X--?X-oX--------X---E-------o----oM----B---XMo-?o---?BoXB---X-o-o-?X-------M-MBoB--XX--X------B---------o-XX--MoBo?oX-X-ooB----------oB-----X--X--X-X-------MB----o-----o--?f
----o-XMB-----M-oM--|X--o--BBB-oX-B?X---o--MXMXXB-o-?M-MXM------BX-M--?--?--------o-B---?M-?B--?-?Xo--------M-----o??XB?M----B---X?MX--o?-?--o?-BX-oX----B-------------X-MB--------B?--ooX-o--?X-X?X---f
-?-X?X----?oMMoBX---X?---?B----X-E--oM-------E-M---?-------X?X-M--X--B-----X--X-BBB-----ooB---X----B-X-BM--X--?---?-------?MX--BoX--o--B-M-----X--oB-???M-E---?M?--X--B---oX-XMB??---M----MX---Xo-X-X-Bf
-----------X----XX--X----------?X??-E-X--X-------X--T------o------T-T-X---------------X-----X-----o--------Eo-o------oo--------oX---?-----X--X---oB------XM---o-o----o--oE---X-----T--------XX-XX-X----f
m---X----------X-X------------o--o-BMo--X---oo---o--|-----oX-X----|o|o-----------X-Xo-X----o-o---------o-MMXB-----------------o---o--X--------X----X-----X--------X-----XM-o-------|---------X---------X
X-XXXXXXX--XX--X-XXX--XXXXX-XXX-XXXXXXX-X--XX-XX-XXXXXXX-XX-XXX-XXXXXXXXXXXXXXX--XXXX--XXXXXXX-X-X-XXXXX-X--XXXXX-X-XX--XXXX-X-XX-XXXXXXXX--XXXXXXXX--XXXXX-XXXX-XX--XXX-XXXXXXXX-XXXXX-X-XX-XXXX-XXXXXX
