--------------------------------------------------------------------------------------------------------------------------------------------------------------------------------------------------------
--------------------------------------------------------------------------------------------------------------------------------------------------------------------------------------------------------
--------------------------------------------------------------------------------------------------------------------------------------------------------------------------------------------------------
--------------------------------------------------------------------------------------------------------------------------------------------------------------------------------------------------------
--------------------------------------------------------------------------------------------------------------------------------------------------------------------------------------------------------
--XMBMBT--B?XMBXX-??Mo---?MX-M?---MB-MM--oX--X---M-?Mo--M?-BX------TM--------?X?----oMMMo---B------oX---?----X----?M?B-X--BM-XXM-B--?BX-MM-M?--M-----M-?---MB-XB---X-B-MM--?X---B-oMBBB--B---M-o--X-o---
-----o-|-X-oo-oX-?-o-M-??--?----B---Bo-?-M--M--X--X--MXM--M--MM--?-|--?----?o-----X-----X-?---XB?-M??B---B--X-MXX-----B?B--oXX--?oX-ooB---Xo-?--TBM-B--o?-X-------XMM-Mo-B?-B?----X---oBB-MXM-o?M--B?o--
-B-M?M-X?MMXo--BM-?---?-o-M--XM-oo?--?-------BM--X----M-X--MBo-?--?X-----M?-?-----M-XM--M--BM----X-o------o------B-?-oo----XoX-Mo------X-?X--o--|----Xo----M-?o---Xo-?----oX---B-M--o-?------BXo---o-XMv
--?---B-o---XBX----B--oB----o---XXo-----------------??o-BX----?o-?-M-X-M---Xo------M-o-?--X--------X--X--oB--BX-M---B---?-XBM?--?-M--------X---?X--E--B----oM--E-XX-M---B--X?B--?oMX?---?--BB----MX----f
----MXo----B--------X-Mo--MBMB--??-?------B-----??B----X--MB---------?--B--B-BM-EM----Mo-?-?B---?-??M--M-Xo-M-o--X-------o-------B--?--X--BX-----?B-o---o--X--X?M-B--BX--?-Moo?Xo----M----E---?M--E--?-f
---B----X---BB-B--?-T--X?MoX-o?X---------EoX-----------------MMo--E---XM--?o---MX-XB---Xo----?X-o---o-M-MB-B--XX--X---o--B-----------X?--X-B-?-XB--M-B-------E---Bo--o-X--X--X-X-M---o-MB-M----oM?M-?-Bf
------XMB------o?Mo-|X---oXBBBo-X-B?X----M-MX-Bo----?M--XM-----XBB-?--?--?---------oBo--?M-?Bo-?-?X--------o-------??Xo?Moo--B---X?MX---?-?----o-Xo-----oB--?M---------X-MB----o-o-B?--o-X-E--?X-------f
-?-X?X----?-MM-B----X?---?---o-X?E---M------B?-M-o-?-o---o-X?X-Mo----B-----XBMX-B---oB----B---X-ooB--X-BM--X?-?---?-o-----?MX--B-Xo------M--o-----??-X??M-----oM?--X--B--ooX-MB?B?--oM-----?---X--X-X-Bf
------E---oXo--oXX--Xo--------E-?MX---X--X-------X----------------T-ooX-o-----o-oo----X-----X-------------o-----o----X--------o-o------X--X--X--o-T------X-----o--o----------------T--o?o---XX----X----f
m----oXM-------X-X----------X?M?---o----X--oo--------------X-Xo---|--------------X-X--X------B------------X-----X-?------------------X----T---X---|------X--------X---------------o|-----oo--X---------X
XX-XXX-X--XXXXXXXXXXXXXXXX--XXX--XXXXX-XX-XX-XXXXX-XX-XXXX-XXXXXX-XXX-XXXXXXXX--XXX-XXXXX--XXX-XX-X-XXX-XX--XXXXXX-XXX--XX--XXX-XXXXXXXXXXXXXX-X--XXXXX-XX-XXXXXXXX-X-X-XXXXX--XXX-XXXXXX-X-XX-X--XXXXXX
