?-------------------------------------------------------------------------------------------------------------------------------------------------------------------------------------------------------
?------------------------------------------------------------------------------------------------------------------------------------------------------------------------------------------------------?
X------------------------------------------------------------------------------------------------------------------------------------------------------------------------------------------------------|
X------------------------------------------------------------------------------------------------------------------------------------------------------------------------------------------------------X
E-------------------------------------------------------------------------------------------------------------------------------------------------------------------------------------------------------
E-Xo-XE?oME?MXo-oo-X?EE--?XoooX-?M?Mo----Xo?o-Mo--?XMX-?E?MXEB--EMEMB-E-EMXBBBX-----E?---BM-EB-B---B?-BE?MoXMBMoEXMo?X-XXEXo-XBoEooX-E-o--X-MEM-BXBMo-M-oX?oE-M-X-M-BM-EEXoooo?XoXEXoo-M?oooo-EoMMoBoB-o
TMMBM--?BXMBEo-XB-?-??X?-BoBBB??o--o-EEXM-oo--MXBo-EMX---ooBoM-MBB-?ooE-??oo---o-B-B?Mo-?X?-----o-ooEoB---MEXEEo-EoE---oo--Mo--B?X-oM--X-BMM?XXEoMEoE?-oo--?oE-Mo-BBE--o?M---BM-o?XMEo?-M--EX-Mo-E-Xo--?
--o-XE---o-?oo?BoXo??E-?-?M-XEMME--B-?X--Bo--BBB?EX?MMBEB?E-?E?---?MXM-XXXoXEMBo-----Moo--o-ooMEE-E-XMX-X??BBEXBM--EM?o---B?M-XoMBB--oo?o-?B-o-M?E--BMB?oM-X--EXB??B-MMX-BE-E?-X------X-X-oM??BoEMXMoB-v
?B-BEXMBB-BX-X-oXo----oMM--EoB-oXX---BMB-B-BX-M-???MXXE-EB-??-oMEooMEMB-?E-M?X?o-ooM-o--MBoXBM?BoMB--oBEEoo--oBBBo---BXoo-B-?Bo---Eo-X-oo---?-XoEMB?MMo-?ooBEM----XoEX-MEM-oB-X-oEBMBB-?-BBX-?X-B-ME-XX-
|ooBEEM-MEMMo?B--o-M?-oM?--BMXB-?-B-B?o?EoEo---XM?-oo-?oE-B--EBEo?o?o-oBB-oX-?MXo-MXXXBM-oX?-E?-o?M-Mo--oEE?o-o-ooM-o-?BEXX--B-EX-o-o-E?oE-X-EooBB-??-EBB?oMoEoB-X----XM-Mo-B---?MMX-B-BoE?M?-E---?BMB-M
EB--oBBX-X-BM?---EXoMo--BB-?XoB-X--X---XE-XEX--M-o-E-B?-E?-BMBEX-XoMX?oEB-Xo---ME--EBXXM-B-MXo?XoX----?B--XEX-EXB-oo?E---MB?Xo?X---oB-XX-XM-E?EXX-oo?M?BX--BMEEo-EMMEo-M-?EB-Boo-ME-B-?MoBEXME--?E-EX-B-
?--X-BBXEMo-o--?--oBoXMoo-?-MBBEoMB??-oBEMBB?-M?XEoE-BBBEEBEE?BM?E----?MME-EMoBMo?MX--?B-B---EoM-BXMXXEMoEEEEoX--ME?Bo-?EEE-X-?--oX-XXo-B-MBXB--B-----M--oEXBE---oXMoooooBE-EEXXMMMooME-o-M--EXoBBo-BMXB
MXB-?oBB-oM-EooB-XX-oXXEBE?Xoo-B--Bo-BEX-oMB---o-?-oo--oB-X???o-?M-oBo--BoBoXM--BMXBE?-XEXBMM?o-Xo-MEo-XB-?M?X-BoM-M-?oXo-M?Mo-M?-oMXEoooEEMX?B---o-Mo?BEE-?-X-?oMB-BBE-?o-XoXoXo?MXX-EB-MBMEEBXM--BEBEo
X--oEBB-E--?-X?X-X-B-B-XBXBBX--XXoo-oooXoXXB---EBo---BB?oB?-oXo-XB-?--oo?o--oB-X-X---B?XXX-Bo-oo-EEo-o--o-E-----X-Bo?E?o--ooo--XoEBB-B--oEEBBB-Xo??-X?EXB----EBo-ooo-o???---BBX-?EoXoBo--?Bo?-ooBo-X----
m-E?-oE-B?X?BEXoo?-o-o?-?X-B--o?--?oXB-o--BX--B?X-oEo-o-EE-B-BoB---Eo----XE--oo-o-XX-XXBB--?o-oE--B--?Xo?-----X-?X??----Bo-o---B?-X-EX-E---o-??oEBXX-oB--B-BE-oEoXoEX-X-X---?B-?-----X-oo?X-E??B--B?-BoT
XXXXXXXXXXXXXXXXXXXXXXXXXXXXXXXXXXXXXXXXXXXXXXXXXXXXXXXXXXXXXXXXXXXXXXXXXXXXXXXXXXXXXXXXXXXXXXXXXXXXXXXXXXXXXXXXXXXXXXXXXXXXXXXXXXXXXXXXXXXXXXXXXXXXXXXXXXXXXXXXXXXXXXXXXXXXXXXXXXXXXXXXXXXXXXXXXXXXXXXX
