?------------------------------------------------------------------------------------------------------------------------------------------------------------------------------------------------------X
o------------------------------------------------------------------------------------------------------------------------------------------------------------------------------------------------------M
|------------------------------------------------------------------------------------------------------------------------------------------------------------------------------------------------------|
M------------------------------------------------------------------------------------------------------------------------------------------------------------------------------------------------------|
B------------------------------------------------------------------------------------------------------------------------------------------------------------------------------------------------------?
M----?-?o-?-?BBooM?oo--o------BoX-X-BXooo--M?MBoXoTo--B--oBXMBM??--o-MM--MoBoo?XXM-MB--BoMo--BE?oMo--MM-oM?--M-XoXX?-o-----M?-o-?ooM--B-X-B?BX-Xo-oXXB-oX----BooX-MXXoMB-oMoX-B--MoTo-MooBBo-X-?--ooBB-X
|M-Xo-o-X--X---MB--??XMo---XX?-MoB?--XMB?X-----MEo|B-o--XX-X-----o-XX--oX-?-X--?B----X?-M-BX--M-X-o-?--o---M--B-o---MX-XMX-----?-MM--B-Xo?----oXX---o-?---o---?Mo--M----M?--X?-oM-M|---??--?MM--X--M--BM
M--BB-o-?M-BM----Xo--o-ooX--X-o----------?Mo-XoBB-X-MM?--Xoooo--Bo?-?o-----X-o---oM--?-M----?-M-o-o---BMoMX-B--B?-B?-?oX--M-BM--o-XXX-oX--?-o?-M----oM--B-M-?---?---o-o?----X----X-X-MM--o----?B-oB--X-v
o??--X-B--B---o--Eo--?-XXX-MM?-Boo-oooXoB--XM----------Moo-oBXB--M-o-?M---?TB------oB-o-MXo--?--BMX-Bo--B-B--Bo--X--o-XM---o----X?B-o-XMMo--B-o---X-B-X----------o-?-MX---B-?-oo-?-?o---oM-M----B?--o--E
?---?---oM--o--X?X-oX-M?XBo---?-B?-XoMB----X-o--oMMX-----M??-M-M--oM---B-?-X-B-B--X?-o---X----o---oo-------?B--M-oXBXMB-X--Bo-?-X--------o----o-o--o---oM-BMM--X-??-o-o------o-B--M-oX----X-o-----MoMB-T
M--B--Bo---B?----Moo----M-M----M--Bo---??-o---XXX----Mo-------o-?-?-??o-?-?B----ooo--?Xo-M----X-o-Boo----XB---------B---X?--M--o-?X?o-o-ooBo-?XBXoo-X-MB-----M-XB--?B-??----M-B-----?---M?-B---?-B----o|
-?--oB-XooB-------o?-BXB---M--M--o-XB-M---o--X?M--B---M--o---MX--B----X------B--B?X-o-?o--MXBMo-M?--XoM-Xo-o--?BMoM--X--X-X--BB??-o-BMXoBM-??-B---MXXM--BBoo--X---B------X-o-X-oo-BB-oB---?-o?----?M-o-E
o--BB---B?--BMo---X-X-?------B--o?---?--o-X?BX------X---Eoo-?---?-----?----M?--?--o?-?-?---B--BM----X?--o--------M-M-o-?MBX-------?o--oX---------?--o-----?BM--------oBooX-M---Moo---M---M----B-o----?-X
ooo--?B---BB--?o--o-oX-o-X----X---??X--?--o----BX-XBX-?B?XBB--o----o-----B---oB--XX-----?-T--T-----Eo-BBMX---B--X-T-B--------B?B-B-BB?-Xo------oB-Boo?X-?-------o---To-BoX-------o--?-??----X--o---To---
mo?-o---XB--o--oooB-o--o-??-o--B----BB--o-X-?-o-BX--B?-------?---X-M-------?-X-BoXXo--o--B|X-|-B?oBMBB--?o--o-ooB-|---?--oXXo---X------Bo--X?-oX-o-??-XX--o-oo--B---|X--Xoo-o-B-?Xoo-X--?--ooXoX-oo|---E
XX-XXXXXX--XXX-XXX-XXXXXX--XX-X--XXX--XXXXXX-XXX-XXX--XXXXXXX-XXXXXXXXXXXXX-XX--XXXXXXXXX-XX-XX--X-XX--X-XXXXXXX-XXXX--XXXXXXXX-X-XXXXX-XXXX-XXX-XX--XXX-XXXXXXX-XXXXXXXXXXXXX---XXX-XXX-XXXXXXXXXXXXXXX
