|------------------------------------------------------------------------------------------------------------------------------------------------------------------------------------------------------o
X------------------------------------------------------------------------------------------------------------------------------------------------------------------------------------------------------X
?------------------------------------------------------------------------------------------------------------------------------------------------------------------------------------------------------B
E------------------------------------------------------------------------------------------------------------------------------------------------------------------------------------------------------M
B------------------------------------------------------------------------------------------------------------------------------------------------------------------------------------------------------T
X-B-B--B-Mo-o?-MMBM-oM-oX-B-Xo-oo-EBoB-?-E-Bo?--M?--M?B?------o?B-B-M?B--oX-??M?ooooBo--?-oM-?-?BB--?MooXoBM-o-?-oXXX-o-o?--ooMM??oo-?oXE-XMXBooo--?B---Boo-XoooB-X--Mo?B?-?o|-MoX-M-BM?MoB?-???BE--oB-E
TB-o-?M---??M-------o--X-o--XM-Xo-B-M---oXX-X-?---------o-?XooX----M------XB----E-Bo---?--X---M---Xo---oBB--ooX-M?-M---MB-MoXB----M-----M-X-B-?--??----o-Xo-X-Mo---M--B---M-MXB-BM--o----o--o----X-|?-o-
---X----oM--------X?M?oB-MBMM---XBX---M-oo--oX-B--ooXXo-X|--??---E--oB??-o--B-??B----o-----BM-----o?M?B---?-------X-o-o--M-MM-BB----???-X-?o---?X----B-Moo-oBE--B------MX----?----M?XXM?X?---o-o--XX-o-v
|--oB--o--MMX-X-XXX---o-------B?--oM---o-X?BBoo--XMMM-B-BX-X--MoXB--B---?M-M-?--?-?-EXo--o----o--o-------?M-EooMB--o----B-X-------------?--?-?--?-o-X-o-?o-BXX----B--M---?o----M-X-XB--o---Eo--X-?XX?M-|
E?oB--o-MB--M-?o?----M----X-BX--o-----oo-?---B-ooB-----o-oooX--M-M?o-MX---o-B-------????-ooBX-X-MX-o-M-MX---X?X----o-MBB-EE-Bo--?o-?M--o-|o-?-XX---BBE?---B-B---MX-oo--oo-X?--M--X-B-??XBX-M-o?-X-Eo---M
|-M----M-----B-M--?-?-X-X-----XoB--B?-B-B-??--M-M-XM-MoE--XXM-o-B--XooMBM--X--BX-MXMo--B-E?--Xo---?o--M-Xo--o-------o---MXXB-?--------o?-X-o-oX?o-B--?---X---?X?----?XoBX---o--BoB--E-oB-M?Bo--oB?MBB-B?
-?--BB--M-?-M-M--M----o-B-MXooMB--?----M----?o-------B???--M-MM-----?X---o?XXBXXB------XBB-?-?X-----B--BM??XMM?BooooX?M-X-?----o-BX--M----Mo-B---o-E?-X---X-?-B-o-BM-XB-o-M-Boo---XXBXo-B---XMMMX------M
M--M---------o--------X-----X---o---XoB-BoX--BME-BMBX--X-MB-o---B--?-Bo-o--XB-BX-X-XoBo-XBB-T-o-MBoB-|-----B-?--M?-B-M-XX-----?X--oo--MM?B-----B?XB?----o-XE---XM?--o---M--M-XoBo-M-?oM---MME---oXoMMMME
|M--BX-B-oo-?X-BXXM-------oB-o-o--oo-E---?oX-?XBB---?Xoo---??XB--??-?----o-B--?--oBB--XE----|??---o-oXo---?---------B-?oB-oo-o--B-B----X--BBXB-B-o----Bo-XBMB----BX?X-Bo----?o--X--o---?M--BX?E??o?--oB|
m--X-o?-o??--ooBBB--o-oBB---o--ooX-?MBB?B-BoXXoo--|X--o-??o-B---B----X--B?-----ooB--oMXBBX-BX---??X---B-B?--?-ooo?X?-----o??-?-X-o--B|-Bo-----o--XX--o-oXB-BB||XXMX--?-oooB?-o?X?-?-Xo-BooX-|B?----X-?-o
XXXXXX--X--X-XXXXXXXXXX--XX-XXXXXXX-XXX--X-XXXXXXXXXXXXX--XX-XXX-XXXXXXX--XX-XXXX-XXXXXX-XX-X-XX--XXXX-X--XX-XXXX-X-XX-XXX--X-XX-XXX-XX-XXXXXXXXXXXXXXXXX-X--XXX-XX-X-XXXX---XXX-X-XXXX-XXXXX-XXXXXX--XX
