--------------------------------------------------------------------------------------------------------------------------------------------------------------------------------------------------------
--------------------------------------------------------------------------------------------------------------------------------------------------------------------------------------------------------
--------------------------------------------------------------------------------------------------------------------------------------------------------------------------------------------------------
--------------------------------------------------------------------------------------------------------------------------------------------------------------------------------------------------------
--------------------------------------------------------------------------------------------------------------------------------------------------------------------------------------------------------
--XMBMBT--B?XMBXX-??ME---?MX-M?--oMB-MM---X--X---M-?M----?-BX------TM-------o?X?-----MMMo---B-------X---?----Xo---?M?B-X--BM-XXM-B--?BX-MM-M?-oM-----M-?---MB-XB---X-BoMM--?X---B-oMBBB--B---M-o--X-o---
------o|-Xo----X-?-o-M-??--?----B-o-B--?-M--M--X--X--MXM--M--MM--?-|--?----BBo----X-----X-?---XB?-M-?B---B--X-MXX----oB?B--oXX--?-X---M?--X--?M-TBM-Bo--?-X-------XMM-M-oB?-B?-o-B?----BB-MXM--?M-MBXM--
-B-o?M-X?MMXoo-BM-?---?o--M--XM---?o-?-oEo---BM--X----MoX-oMB--?--?X-----M?o--------XM--M--BM----X---------------Bo?-------X-X-M-----o--MBX-----|----X--o-EM-?----Xo-?-----X---B------?oo-o--BX--Xo-?oMv
--??--B-----MB-----Boo-B--------X------BB-------o---?M--BX----?--?oM-X-M---X----o--M---?--X--------X--X--oB--BXoMoo-----?EXBM?oo?-M-----o--X---?X--MBB----B-M----XX----oB--X?B--?-MX?B--X--BB----M-----f
----MX-----B--------X-Moo-?-----??-?------B---o-??B-o--X--BB-----o---?-oB--B-BM-oM----M--?-?B---?-??Mo-M-B--Mo-M-X--?---------------?--Xo-BX------M---X-B--X---oMoB--BX?-?-Mo-?X------------------E--?-f
---Bo---X--oBB-B--?-T--X?M-X--?Xo----o-----X----o------------M---X----XM--?o-o-MB-XB---Xo----?Xo-----BM----B--Xo--X------------------X??XX-B-?oX---oEB----------oB--o-----X-MX-X-------MB-?---o-M?X----f
------XMB----o-o-M--|X----BBBB--X-B?X------MXoBo----?M-oXM-----XBB-?--?--?o--o-o--o-B---?M-?B--?-?Xo------X-B-----o??XB?M----B---X?MX-o---?--oM-BXE-X----B------o---?--X-MB----E---B?--o-X---o?X-o----of
-?-X?X----?-MM-BX---X?---?--o--X?-oo-M---o--X?-M---?---o---X?X-M--X--B-----oMMX-B-X-o----oB---X---EX-X-BM--o--?-?MX-------?MX--BoXo-E---oMo----X-M?B-B??M-----?M?--X--B----X--oMM?---M--E--??MoXMXX-X-Bf
------o----X---oXX--X--o----------X---X--X-o-----X--M---------o--oT-ToXX-X------------X-o---X---------------o------E-----E---o--X---Bo-X-oX--X-----o--o--X---------------E---X------------oooo----X----f
m-o-X-X--------X-X---ooB--o-------------X--------o---------X-X----|-|------------X-X--X-----TX-o----------X------XBMM----------------X--------Xo--------oX--------X------B-o------o-----X----X-o------oX
X-XX--X-X-X--XX-X-X-XX-XXX--X-XXXXXX--XXXXX--X-XXXXX--XXXXXXXX-XXXXXXXXX--XXXXXXXXXXXXX-X--XX--X-XX-XXX--X--XXXX-X-XX-X-X-X-X-X--XXX--XXXX-XX--X-XXXXXXXXX--XX--X--X-XX--X-XX-XXX--XXX-XXXXXXXXXXX-XXXXX
