--------------------------------------------------------------------------------------------------------------------------------------------------------------------------------------------------------
--------------------------------------------------------------------------------------------------------------------------------------------------------------------------------------------------------
--------------------------------------------------------------------------------------------------------------------------------------------------------------------------------------------------------
--------------------------------------------------------------------------------------------------------------------------------------------------------------------------------------------------------
--------------------------------------------------------------------------------------------------------------------------------------------------------------------------------------------------------
--XMBMBT--B?XMBXX-??M----?MX-M?---MB-MM---X--X---M-?M----?-BX--o---TM-------o?X?-----MMM----B-------X---?----X----?M?B-X--BM-XXM-B--?BX-MM-M?--M----oM-?---MB-XB---X-B-MM--?X---B--MBBB--B---Mo---X-o---
-------|-Xo----X-?-----??o-?----B---B--?-M--M--X--X--MXM--M--MM-o?-|--?---o??-----X-----X-?---XB?oX-BB---B--X-MXX---o-B?B---XXo-?-X---B---X--?M-TBM-B-o-?-X-------XMM-M-oB?-B?---------BB-MXX-X?M--BX---
-BX-?M-X?MMXE--BM-?o--?-o-M--XM--o?-o?-------BM--X----M-X--MB--?-o?X-----M?-o-----M-XM--M--BM----Xo-o------------B-?-------XoXBM-------X-?X--oo-|---oXM---oM-?----X--?-----X---B------?---o-ooX---o-?XMv
--??--B-o-MMXX-----B---B-------?MM---o--------o-----?---BXoo--?--?-M-X-M--oX------oM-o-?--X--------X--X---B--BXoMo-o----?oXBM?--?-M-----o--X---?X--oMB---??-M--o-XX??o--B--X?B--?XMX?--M?--BBo-o-MX---of
--o-MX-----B-o------X-M---?--------?------B-----??B----X--M-------o--?--B--B-BM-EM---oM--?-?B---?-??M--M----M-XM-X--?-E-o?--o----Bo-?--Xo-BX-----B??-o--B--X--B?M-B-oBX-o?-M--?Xo----M-o--o----B--o--?-f
---B----X--oBB-Bo-?-T-oX?M-X--?X---oo----o-X---o-------------XB-o-?---XM--?-o-BM?-XB---X-o---?X-------M-MBoBo-X---X---B-----------o--X?-?X-B-?-X-o---B--------o--B--o--X--X-MX-X-------MB-B-----M-B-?o-f
------XMB-------BM--|X----oBBB-oX-B?X----?-MXoM?----?M--XM---o-XB?-?--?--?--Xo-----oBoo-?M-?B--?-?Xo-------oM------??XB?M----B---X?MX--o--?-----BXE-Mo---B----------?--X-MB---------?---oX-o--?Xoo-----f
-?-X?X----?-MM-B----X?---?B--o-X?----Mo----o-?-o---?o------X?X-M--X--B-----X?BX-B----X----B--oXo--M?-X-BM--X--?---?-o--o---MX--B-Xoo---?-M----XXMBXo-X??M-----?M?--X--B-oooX-M-XX?--oM--M--M---XXMX-X-Bf
----o------X----XX--X-------------X-E-X-oX-o-----X-oT----------o--T---X----o----------X---o-X----------------------X---------o--o------o--X--X----?------X----o-o------------------T--------XX----X---of
m---X--o--o----X-X-----o--oo-------M?---X----o------|o-o-X-X-X----|--------------X-X--X------X-------o----X------X-------------------X---o----X----------X--------X------oo--------|---------X---------X
XXXX-XXX-XX--X-XXX--XXXXX-X-XXX--XX-XXX-XX--XXX--XX-XXX-XX-XX-XXXXX-XXXXXX-X--XXX--XX-XXXXX--XXXXXXXXXXX--XX-X-X-X-XXXXX-XXXX--XX-XXXXXXXXXXXX--XXX--X-X-X-XXXX-XX--XXXX-X--XXXXXXXXX--XX--XXX-X-XXXX-XX
