o------------o----o------o------------------------------------------------o---------------------------------------------------------------------------------------------------------------------------?|
M-----o------o------o----------------------------o---------o-o-------------------------------------------------------------------------------------------------------------------------o--------------|X
--------o-------------------------------------o---------------------------------------------------------------o------------------------------------------------------------------o--------------------|B
-----------------------------------------------------------------------------------------------------------o---o---------------------------------o--------o--------------o------------------------------
--------------------------------------------------------------------------o---------------------------------------------------------------------------------------------------------------------------|?
X-?--oBo?B--M-------EM---?---X-M-X------B-?--?--?-----Bo---Bo--o-?---?-----MB-----------X-------X-B-?-o--B-oM---o-?-oXEoE--??---?o--EE---X----E--------?X?-----B-----BX---oBB--oo----?-?-ME---o--B---MX|
BMEo-oX-----XB-M--o-B-?o-?E--M-----B----M-EEEo------X-Xo--------X---E-o---?BM-Xo-MoM----B---M---ME?-BB-------B?EMoX-?--?X---o-XE-X?--B?---B-M-M--B--BX?MM---------EE-BE--M---M-oEEB--M-B-E----E--?-B--oB
E-??B---B--B--B-M--?---------B-E-----M--?--E-X--?E-B---Mo--M--o-EX?--X----BBo-E-----o-------BMo---?ME---?B------oEB--E---oBE-?-?-?---X?-E-?E--------M-------E-?XXB-?---X-M-----X----?EX--------EM----Mov
M?---MM-BXB-MM----oMo?-?oo-X--o----?-o---B-E--?-oo-oXB-o--E---------MB-?X--E?M---MB-?--M--oM----?-X----MEX---oX-----E-----o-----B?-EMBME--MEB-o-BM-XEXM---E----MM--?--oM--X--M---X--X----X--?-E---o--?MM
-M----EE-o--o-X-o----o---?-oXBo-M--?o-----E-X--B----X--B?--E-------M-BB-?-----o----E-E-E-------E---?-----E--oB-M-M--?-------------EX?-M-X?-------MB---o----X-o-o-?-o-o?-B?MB-oM--M-----M-o--M----?--M--T
M-M?-E-------X----EE-B-B----E-M----E------M-B--?-X-----oB---X---o-X------EB-EX-----MM----M-X-?-Bo---EEBME----o----M---o--M--EE-E--BX?---?---XB----?E----M---o------E--o-o---o---E-X------?--?MM--MMo---B
|-------o---o-?-o--------------M------------X--------E-MEB-?o-o--?M-Moo-oX--MX-----?-Mo----------B-?---Xo-?M--?---E-?--?--BM---?-MX---?-B---------E----o----B-M--B----?Mo-----EB----E-M-E---XB-M---M-BEo
X--o----?-MBME--oE--E----M-E-o-o-M-E----??-XXo--oo--Mo?--o-?---B-X--X-B-o-M--o--E---MEo?Eo--o-B-M-----oM---M-?--------oo--------oB--EMoE-MX--oX-----oB-----?EX-o----B-------Eo------E----M--BEM-------B-
X---XEo--X----o--B-E----XX-BXX-o--B-----Eo--E-o----E-X---E-----E--?Bo--E---------B-E-?--E------oo-X--------o------o-o-X---??-oo---?-B-----?---E---E-EE-?B---EB-o--X-E-o-XB?-------------o----XBE------?B
mE-?--o-X-o------?-?---B---B?------o-o?-B-oXX------BoX-oo--oXB--X----B--B--Bo?-------B--Eo-----BB--B----B-B--o--o---??-X-?--B-?----o---B-Eo---E-oo-----?-----o-?--B----B----------XX--B--o----?-BX-?E-|B
XXXXXXXXXXXXXXXXXXXXXXXXXXXXXXXXXXXXXXXXXXXXXXXXXXXXXXXXXXXXXXXXXXXXXXXXXXXXXXXXXXXXXXXXXXXXXXXXXXXXXXXXXXXXXXXXXXXXXXXXXXXXXXXXXXXXXXXXXXXXXXXXXXXXXXXXXXXXXXXXXXXXXXXXXXXXXXXXXXXXXXXXXXXXXXXXXXXXXXXX
