?------------------------------------------------------------------------------------------------------------------------------------------------------------------------------------------------------T
X------------------------------------------------------------------------------------------------------------------------------------------------------------------------------------------------------E
X-------------------------------------------------------------------------------------------------------------------------------------------------------------------------------------------------------
X------------------------------------------------------------------------------------------------------------------------------------------------------------------------------------------------------B
o------------------------------------------------------------------------------------------------------------------------------------------------------------------------------------------------------E
T|-oMBo??-MBoXXB-?M----oo-Mo-Eoo?MBo-o--MM?oo--oXX-oB-oXo?o-oBXMo--o-X-X-BXEo-?-Boo-X?M?XX-o---?B?--X-oBBEMXMooo?B-BMX-o---oXo--oo-Bo-EMMooMX?o?-MB--ooXM?o-M?-M--oX-XXXM?-BBME-XM?M-B-??oXX-oBM-MB-XE-M
oX-o--B--M--X-?-B---o?oM-M-X-X?-----o-X?---X-?XMo??M-oB-E-X-o-M-MoBB|o--E??XME---?ToM---Eo-MoM----oX?Mo--X---BMo--B---XX|o-o-?BoMX--o-?--M--M------?-BME--XE----BX--?-oo------B-o---|-o---B-oE--o----XBB
--Mo--MXB--X?B---o-MB-B-?--X-E-M-X-oM----|-oX-B-?---oB-oXo-Bo-------XM?BXXX?M?M?--|M-??BMB--o--|--BM----X-?-?--B------MMXBoM-----BX?BBo------B---X---MMXMBXX-BM--o-M-?--o-o--XB-----X-BBME-oX?XoMoX?T--v
MB-X---??M----o-BMM----B-MMB-B--Mo-B---XXXXB-B----X?o-BB?B--XoX-X------MMBMX-B--MMX-X-o-M--XMMMX-?------XB-?--B-?XM?o---?-o-Bo-o--o---E?--XM-----oo-?X-M---XX---??--B---B-o----M??XBM?-XB?MXoXoB-oo-|--?
----oMB---|--oX-----Bo-------ooX-----o--M-M-M-o-o-M-MX----M-----oMooXB--BME---o----oo--------------B--o-M-M-----XMXXBB-o--Mo-B-X--oX--B---E-?oB?M-?o--o---o-M-----o?--M---B-X-o---E---MX--M-ooB-M?EoX--o
-M-B----o-X--MB--MEX-M-B--B--MXB----?-BB-o----X-X--?-o---MXBM?--X-?Mo-oEBBMX--?B--M-oXoX--XM----o---o?XB-B-B-B--oXXB--X?--------M--B--oo-o?--M--------B-oMXM-o-B--X--?-o-o-B-E??M?B-BX-B---E-M---?XM-B-T
X---B-M-?B-----X?MX?B-E--X-B?-X--Xoo-o---?-M-B-?-BX--B----B---o-Xo---M?B---MM----M-?--M-?-X-oB--?-?-?-X-E---X-o-ME--X-o-M-MXB?o---o--X?-M--BX---Xo--Xo----?-M----Bo?--o-XM--MX---BXX--?--M?M?----M--o-B-
?-?----B---E-oB?MBB--XB-E?B--o-?--o--o-B--B-----------?BM--o?----?--E-XoooX----M-------X---??------B---M?oo--o-B?XXBo-X--B-E--oB-??M---o--B-M|-X--|-oB-oX--B-B-?--o-M??-X-?o--?---?TM----MBB-X----M--o-o
|--??-o--XB?X?X-o--B-?XMM--o--o---oo-oB-Bo--X---oX-o---------BoBB--oM-?-XX-B------X----B--------o---?BX-?o-B----oo--XE--X-XXM-B---------B--X-X--o-XBE-oB-BB-B-?-oBX?----o----X-B---|-o-o---M?-oEBo-o-Xoo
m----o--?-oX?-B?o-B-X---Bo-B?X--X-Xo-o----?B?|?-XB-X---B-|BXX-o---XB-o--oB---?o?-B??To----oo----o-?X--Bo--o-----?---BM-o-B-??--B----?-To-o-ooXo-B??XX--------B-X---o--X?o??X-BM--X-XX?B-B?o-o--M-B-B-o?M
XXXX-XXX-XXX-X--XX-XX-X--XX--XXXXXXXXXXX-X---X-XX-XXXXX-XX-XXXXXX-X-XXXXX-XXX-X-X---XXXXXXXXXXXXXX-X---XXXXXXXXX-XX-XXXXX-X--XX-XXXX-XXXXXXXXXXX--XXXXXXXXXXX-XXX-XXXXX-X--XX-XXXXXXX--X--XXXXXXX-X-XX-X
