E------------------------------------------------------------------------------------------------------------------------------------------------------------------------------------------------------o
E------------------------------------------------------------------------------------------------------------------------------------------------------------------------------------------------------B
M------------------------------------------------------------------------------------------------------------------------------------------------------------------------------------------------------E
o------------------------------------------------------------------------------------------------------------------------------------------------------------------------------------------------------M
B------------------------------------------------------------------------------------------------------------------------------------------------------------------------------------------------------o
T--Mo----o--o?-M--o-o---BoX--oX--Eo-o--?B-o---o---o---ooo-oX--Xo-o-X--Moo-o-Mo----o?-------o--B---o---B-oM-o--o-ooo-B-o------o-o----X----Bo----B-B-ooo-----oo--o-ooX-oo-o?--o--oo-X-oo-ooo--o--o---oM?-T
X---o--oo-oo--o-----o--B----oo-MMBX--o----o-X---o?--o-M---o-o-oo-Boo-o--o----o-o------o--X----o-oo-----o---X--MoX-o--o--M--o----B-o-------o-oo--o------o---Boo----oo-o---------o----o-M---ooX----?-M----
Eo--o--Bo-----o?-o--------oM--Bo-o---o--oo-o--o---o-oo--oooX?--o--o-o-o--o----------o-o-----B-?----o----o-o----o--ooo----M--o--X-o---o--o--o-o-oEXX---o-o---ooMo----E---o-o---o--------o----o--ooo----ov
B---o----M-oo-oo---MM-oB--o-o-----Mo----oo----o--X-E-------o-----?--o------M-----o-o-o--------------------X--o-o--o-o---oo-o--------?MMooo----o?B-Bo-----o------oM-o----M-o---Xoo---X--X-o-o-o--BBoo---X
BooXoo-------o-o-o---o---o-?-oo--o-oo-------o-ooo-BM?o---X---------o----o---?-o-o---oo-o----oo-----ooo--o-----o-oo--X--o-----------o--o-----o----------------o-o-----o--o------------?-----o--o---o-B?BB
Xoo--------------B--o-o?X---o---oo-----Xo---MX-M------o--o-M--o------oo----oo-o----o--B-ooo----o--o------------oB----o--o--M-E----o---------?o--oo--------------oo---o----o-o-oBBoMo-------Bo------o---B
E-o------o-o--o---Mo-----o---------o--oooooo---oX--B-o-oX--o--o------XB-Mo--o-----oo?o-----Xo--o--?oo-o--E--o?-----?ooo---o--M--oo--E----Eoo----o---o---?X-----oo--o-o---o-oBoo---o---X-oo--oMo--Mo--Mo|
Mo---o-------------o-----o---Mo---o?-----------X--o--B------o--o----------oE--Moo--ooX-oo--------o--??ooXX-----o-o------o----o-o--o?o--??MXoo---o-------o------o-ooooBooooo----o---o-o-o--o---o--o-oX--X
----o--o--X----o-------------o---o--oX--o---o------Eo-o--o-----o----------XM---o---o------X-o-oXo--o-----o----------o----o-----o---o-------oo-o--o------------oo-oo-o-o--o-oo-------Xoo----o---o-----o--
m-o------o--o--ooo------o-o----oo-o----ooo--------o--oo---o--ooooo---o-oo---o---o-o-ooo--o------oo-o-o-oo-----------------o--o-------o-X-----o---------------o--oo-oooo------o-oo----oo-X--oo--ooooo-o-T
XXXXXXXXXXXXXXXXXXXXXXXXXXXXXXXXXXXXXXXXXXXXXXXXXXXXXXXXXXXXXXXXXXXXXXXXXXXXXXXXXXXXXXXXXXXXXXXXXXXXXXXXXXXXXXXXXXXXXXXXXXXXXXXXXXXXXXXXXXXXXXXXXXXXXXXXXXXXXXXXXXXXXXXXXXXXXXXXXXXXXXXXXXXXXXXXXXXXXXXX
