--------------------------------------------------------------------------------------------------------------------------------------------------------------------------------------------------------
-----------?------------------------------------------------------------------o-------------------------------------------------------------------------------------------------------------------------
---------------------------------------------------------------------------------------------------------------------------------------------------------------------------------------??????-----------
--------------------------------------------------------------------------------------------------------------------------------------------------------------------------------------------------------
--------------------------------------------------------------------------------------------------------------------------------------------------------------------------------------------------------
-------------------------------------------------------------------------------------------------------------------------------------------------------------------------------------------------o------
----------------------------------------------------------------------------------------------------------------------------------------------------------------------------------o---------------------
-----------------------------------------------------------------------------------------X-------------------------------------X-----------------------------------------------------------------------v
------------------------------------------------------------------------------------------------------------------------------XX-----------------------------------------------------------------------f
-----------------------------------------------------------------------------------------------------------------------------XXX---------------------------------------------------------????----------f
------T---------------------------------------------------------------------------------------------------------------------XXXX-----------------------------------------------------------------------f
------|--------------------------------------------------------------------------------------------------------------------XXXXX-----------------------------------------------------------------------f
------|-------------------------------------------------------------------------------------------------------------------XXXXXX----------------------------BBBBB--------------------------------------f
------|------------------------------------------------------------------------------------------------------------------XXXXXXX-----------------------------------------------------------------------f
m-----|-----------------------------------------------------------------------------------------------------------------XXXXXXXX-----------------------------------------------------------------------X
XXXXXX|XBBBBBBBXXXXXXXXXXXXXXXXXXXXXXXXXXXXXXXXXXXXXXXXXXXXXXXXXXXXXXXXXXXXXXXXXXXXXXXXXXXXXXXXXXXXXXXXXXXXXXXXXXXXX---XXXXXXXXXXXXX-------XXXXXXXXXXXXXXXXXXXXXXXXXXXXXXXXXXXXXXXXXXXXXXXXXXXXXXXXXXXXX
