T-------------------------------------------------------------------------------------------------------------------------------------------------------------------------------------------------------
X------------------------------------------------------------------------------------------------------------------------------------------------------------------------------------------------------?
M------------------------------------------------------------------------------------------------------------------------------------------------------------------------------------------------------?
X------------------------------------------------------------------------------------------------------------------------------------------------------------------------------------------------------|
|------------------------------------------------------------------------------------------------------------------------------------------------------------------------------------------------------B
XBo-?-?--MoBBEoM?M-BMXB-B---?Mo----?o?MB?--oBMX-oXo-MoB?o?XB-B--E-oEM-X?-o-B?B-?T-XBB-BM-EoX-M-XXoM?-?o-XMoBB-o?M-XBEo-M-?-MBoB?Bo-XBEo--o?o?E-M-MEBoMoBo?BXoo-X-M--BXo-Xo?B???-X----?o-?-B?B-M?Mo--MM-T
-----?--B----X----?----B--M?--?X--B-M----o-X--o----M-o--M-M-o-B?XB-M-----ME-----|o---B--BMXB--oM?---T--------M---oo-X-?---o--X---X?o-Mo?---?XMB---?-?-o-?--oM??-M----XB--X-----BBB--M-?B---------?-M--?T
M-oB---X--Xo-EM-Xo---BB-----Eo-oo--X-o---X--B-B?o?o--M---o-oB---o-MBoMMB--M-BB--XMXM?-oMB---?BB-----|?o?o-o-?-XoMoXM?---o-BB--o------Bo-o-|---XB-----Bo----o---o--MB----XXo--o----M?----X?M--oo---M-M--v
M------M--oMMMB?XM-o?BX-BoMMBMo-M---XB-BoX-E------E---BB-?B----Moo--o---BBoX--?-o-X--??----o-----o--X-o---BB--BX-oMo-?-Boo--oX?-XB-oo-M-M-X-oMo-M-oBX-?B-BXM?--Xo----o--Mo-Xo?--oX--Bo-----?-MoX-?-M-X?|
MMMXBo----B--o-----?-----oo-M-BX---?--M-M?M?-Bo-MX?-?---B---o-o-?M-----X--X--B----X------Mo?o??B--B---oo-E---o---?-X-----o-BMo-Bo-E-o--o-?-------Eo-oM----B----o---M-XBM-?-o---MM----M---Xo-o-oX-------|
B??o?---?M---Bo------o-o-??--o-MMoo-M--B---o--Bo--?--BEX-?--B-M---o-X?-M---M---Xo-BooB-B--o-X---XX----X-?XX-EXMBo-XMMMBoEB?--B--M??X?-BXB--B--M?BM?oM---Mo--B-MM----B-----oXBM----EBo----MB-o--M--oX---T
M--M-M------o-Mo?o-BMMXX-----M---BBX------?EM--MB---TXBBX----o-Bo-B-B-o-M-M-o--?Mo----B----X?B------EBoXX?-M?-E--?o----B?--o--?B-oo----o--------X?B---XM-MB?XB----?---??o-M-----?BB-?-MB?--oX-o--X?B?-oX
Xo----?B?--M-M-M-oM---B?BXBo--o??X?BB-?o-MMB-----?BX|MX--Bo-BB--MB-B--MM-?--Xoo----oo-----oB---Mo---X---B-BB?XB?X-B--XX-X--X-M-BMBXM-?-?X-To-o--o--M--o---oBB-MX-----o--X--B--o--?M--M----M--BXXXX---o?T
TB--------X-X---X--o-------BB-?--oE--B-o--o-X---o--?X-X-B--X---B--o-?---B--X-Xo---oBBX----B---X-oXo-Xo-?--------?--?-X?Xo-o?o-------?---o-|?-?X?X-E--T-EX-X----------?-Bo----Xo-o--?--B-X--oB-XX-X---T-M
m-oBM???XBXXoo?Xo?-ooX--B-o--o--BM?Bo--X-XXBoo--BoB-X------B-o--o----o-?---o--?--XB---oooo-X|--T-?-oXo---|o?|?o--X?-BB--X-B-B--o--o--?o?oBX-o-B-?BM--X-BTo----o-o-X-B-o-B-B?o?--X??-BB-oo--o-X-XTo-oMMBB
X-X-XXX-XXXXXX-XX-XXXXXX-XXXXXXXX-X-XXXXXXX-XXXX-X--XXXXX-X-XXXXXXXXXXX--XXXXX-XXX-X-XXXXXXXXXXXX-XXXXX-XXX-X-XXXX-X---XXX-X-XXXXXX-X-X-X-XXXX----X-XXXXXXXX-XXXXXXX--XX-X--X-XXX--X--XXXXXXXXXXXXXXXXXX
