------------------------------------------------------------------------o-----------------------------------------o------------------------o------------------------------------------------------------
-------o------o-----------------------------------------------------------o--------------------------------o---------------o-o-----------------o-----------------------------------------oo-------------
----------------------------------------------------------------------------------------------------------------------------o--------------------------o------------------------------------------------
---o----------------------------------------------------o-----------------o--------------------------------------------------------------o-o------------------------------------------------------------
-----------------------------------------------------------o--------------------------o-----------------o-------o------------------------------------------------------------------------o--------------
---??M-----M----M--o---o--Xo-o-X-----?-----B-o-o-?----------E--E-oo----?------EE---E--B---BM--?-X-EB--M--MX-M?-?Moo--M--MX----?-------B------X--------X-ME-X-E---------?MX-oE-o--B---Eo---XB-----E------
---------B------?o---oEE-----Bo-XX-E----o-----o------B-E-E-X------?--?---E--B-o-----o?XX---M-B--X-EM--X----?------------o-M--X--o-E---M--------B----o-?-X---o-EB?oB---o--?-----X--Bo----oo----X---oB-?--
-o---------X?B-MoB--M---?----?MoM-BE?-M--B----BoEM----o-----o----XE--M--E-XE-o--X---E----M----o----------E--o-E-MX---M-------M--?-o--BE--?---X-M---o-M--E---Bo--o------?---X----oM----?----X---B-X-E---v
-EX-----BBM----oE-o---E--B-XX-?--E-X--o--------?----oM-X--EX-o--E-----Xo--M----------E---------X--o-?-o-E-X-o---o----XBE--?E--------E------XME-E-----oo--B--------M---MoX--X-o-MM---o----?--B---E?o--E-f
--E----oE??-------?BBM-B?--M------B---B--oX?E----o-MX-oX-----E------EXB-X-oBEBoo----M---------?----?--?o?--B-?M--??----?--o---Mo-E---E---------EMX-o?-M--o--M-BBE-BM-E-M------------?--o-o-B--MX-E-M-X-f
--?---E----E?E--oM-EMo-o----------E---------------EM---?--o--BE--?------?o----M-MX---XE--o-?X-o--------?M-E----?-Bo---B?----o--?----o--E?-XBE----ME--o----XX-X--E--XM-?-X-E--o-M-X-B--o-oBoo--?B?------f
-E?--X-----B---M-o-Eo--B--?XXB-o-------M--------E--------X--B-o--BM----o---?-E---E?-M----X?--o--------o-oEB---X?--M---X-oB--X-B--?X----?-----?--o-MB-X-E--------o-?----?-XX------E-B--B----E-B--o?-M-o-f
-----oE---E--X---XEM-ME----E-BXo------oB---Eo--MMBo--o-?XoE-MEM--XEE-E--?---E--E-----X-XM-o?E--B----XBB-E------------o---M--XEX-oB--BE---?--?-M---M--XB-E---E--oBB--E------------B--B-----o-?----------f
-oo---X----Xo----o-E-Eo-oo?--oB?----------oo----------?----BB--Bo--E-----X------E---?---?Eo----o-o------------?-o--E-oB----o--oE---?---------ooo-------o---oX---X----B--E-X---XE--X-o--X-EXEo-?-?o---o-f
mX----?-B--oB----?X----oB?-?-----X-----EE---?-?---?--?----?---?---o---o-------------ooo-E-----------?-BE---?----o-------X----X-E------E--X---E----oE---o------?X?oB-----E--?------B-----B----B---B?X---X
XXXXXXXXXXXXXXXXXXXXXXXXXXXXXXXXXXXXXXXXXXXXXXXXXXXXXXXXXXXXXXXXXXXXXXXXXXXXXXXXXXXXXXXXXXXXXXXXXXXXXXXXXXXXXXXXXXXXXXXXXXXXXXXXXXXXXXXXXXXXXXXXXXXXXXXXXXXXXXXXXXXXXXXXXXXXXXXXXXXXXXXXXXXXXXXXXXXXXXXX
