--------------------------------------------------------------------------------------------------------------------------------------------------------------------------------------------------------
--------------------------------------------------------------------------------------------------------------------------------------------------------------------------------------------------------
--------------------------------------------------------------------------------------------------------------------------------------------------------------------------------------------------------
--------------------------------------------------------------------------------------------------------------------------------------------------------------------------------------------------------
--------------------------------------------------------------------------------------------------------------------------------------------------------------------------------------------------------
-XXM-?-BM-B?oM---BX?---XX----Bo??-B-----?--?---MME-M--M-?o-MX?---MM-?M??-M--?-M-B--M?---?o?-XX-----?---MM-o----X-------B----MB--MBX-?oM?---?XM--XX---BX-?oBB--M--M?--XoXMXo-M-oXo?X--TM-??-Bo-B?B?M?----
----?-o-o---Mo-?oo--??-?-?BM?-Moo--M-M?M-BB----o-?-o-?-B-BX---o?-----o--?o----o--------M-Mo--B--XB--?XBo--X?-BXX-M--M-Bo-M?M-o-M---?-B--X-M-ooBo?-----M--B--B--X---X--Mo-??-oB?MM-M--|o?-o--M--o------?-
-M----MX-X----Xo--MX---oo----?----B---oo----M--X-----oM-o-MXMXB---X-X---o----oTB----B-M--o------B-?----?------?---XX---MBo-o???---M-?--Mo--BM--Mo--XBM-X--M--?-XX---o--X---o-oo--M---XXoX-M--M-B-X?-B-ov
-o-E---Bo--X-?-M--o-M--oX--M--?XB---?-o?-----XM--XMM-B----o--oooX-M--XX-----B-|-EM---?-B-oBM?Bo----X?-X-M?--B---M-Xo-------M----?-----?-M----Bo----?-----ooM---o-MoB--o-?-oX----M--X----o-o---?-o------f
--XB-M--?-Xo?o---M-oo--?M--------o-Xo-B-Xo?M---?-------M-------?-M-B-?-o-M-Xo-X-o-M--o---M-o--BBX--M--?M----oX-X-?MB--B?-o---o---B-X----B--X--XX-BX---oM-M--?M-X-o?---------BXB-o-B-o-???--?----?-oX-X-f
----o----X-?--?---XB-----?B--MX--?-M-o-BXB--BX--BXo-B-----------?oB---?-?-BB-X--oMo-??--?o-MB--oXoB-------B--?--B-oo---------B-M---MX--o----o---o-B---X-X---o----B---B-M-----?---M-MX--o-----BXo---X--?f
-?-BB-o?M----B--?-B---------B-X?--?-MB-o------X--?BB-XB---M-?XM-----X--------?M??-XXo------o----oB-XX-M-------X--------XB?----o--M----BM------MBB--XXM-----B---?B-B-----M?oMB-XE?o-oM--X-B--?o?XoB-XBM-f
-----?M-oXBBBoX--?-X-Bo----E--?--o----M--BX?-?M--o---?o-XM--o--B-?E?--------B--o---?---------M--BM---Xo-oME-M-?XB-E?-XBB----MM-BM--X---o--E-------E----BX?--B---------B-o-Xoo-??-X--o--?---B----B--M---f
---------------X------X-XEXB--------X-------X-oX----o-----E-------B---X----X-X----X-X--X-o---------------oBo-E----?--o------o------T-----X?X---X-B?E------o-----------------------------X----------o---f
m-------o-----X-----o--XoMX---------X-XX--------X-------?XXB--------------------X----------X-----X-----X--X--X-----o-----X-----X-X-|----XXX------XXX-------------X-X----------o-X--oX-----------X------X
XX--XXXXX-X-X-X-XXXX--XX-XX-X-X-XXX-XX-X--X--X-XXXX-XXXX--X-XX--XXXXXXXXXXX--XXXXXXX-XX-XXX-XXXX-XXXXXX--XXX-XX--XX--XXXXXXXX-XXXXXXX--XXXX-XXXXXXXXXXXX--XX-X-XXXX-XXXXX-X--X-XXXXXX--XX-XXX-XXXXX--X-X
