----------------------------------------------------------------------------------------------------------------------------------------o---------------------------------------------------------------
------------------------------------------------------------------------------------------------------------------------------------M-------------------------------------------------------------------
-----------------------------------------------------------------------X-------------------------------------------------------------------------------------------------o------------------------------
-----------------------------------------------------------------X--------------------------------------------------------------------------------------------------------------------------------------
------------------------------------------------------------------------------------------------------------------------------X-------------------------------------------------------------------------
-X-MX------X------M--oB------------o-??-----o-E?---?-E-----XXE----B--M--------B-oX?-E-E--o---o-?-?B--------X-o--o--o--X-----------B-------?-X--M--E---?--X-----?---o-----Xo?---X-B---?-----Boo--X----MM-
--------o----o-------B-o--E-o----B-Bo----E?-B-M----o---o----XX--?--X?-------X---X-o-?BBo-oo---o-X---E----o---XXMM--------X--o------?o-M---oB----?--?B----oEX-M----oB---o-o------------------XM------E---
-B?----?------?------o--M?BX--X----o--BXM?---o--M----XMMB-?---X----------B-oX-ooo--o----M--o--MMo--?X-M-EE-----o-X-?-----B-----Mo-?-M-----oo-M--o-------BBXX-----M---B-----M--M--------?E--o------M----v
-----M?--oo-----?----o-o--o--------B------EBo----M---o---o------------B------M------------------B----M--X?M-M----B---EE--o-?--o-oEo-------oBoo------------B---?M--M-M-----M----E-----B-o?----E----oX--Ef
-?----oo--B-o--o--B---MB--X-?--------M---oX--?------?M?MB----------X-------------E---E-----X-E-o-X-M-------------o--XBBB------?-MBX-B-?X------------E--------o---oo---o-o------X-----o-E-XMoX?X-----o-Bf
-o?BX-X---o-?E-M-----------M-M--B-------E-MM---o------------X-B?----?-B-------M--?-??XXE-----BM-----M---------M-M-E-XE-o---BB---------o--------X--XBB---o---E---------?-B?E--?-o?--M--?MM-oBXo----o-X-Xf
---o----M-M----o-----------o-o------X---B------B---B--o-----M-o--MMX-------------M--M--------X---M-------B-X-?---E---?--?----M------M-----B--oB---M-----M-o??X----------o---X--Bo----X-o-------BX-X----f
----E--B---oo---E-M-----------MM-------B-oo-M--------X-----B-B---o-MoE----X--?o----?E---XX----M-BoBo-B---------???M------------?-----------X-o---------------E----B-----------X----?-M----------B------f
----?o-o--------X--o--------------X--o-o-X---o---------o--------XXooXB---o----------B---------o------o--o-------o-o----------o-----------o------------X-----MB--------------o------o-------------------f
m-------o-------o--------------X-o---------o---o-----Xo--o-------o--Xo----------oo----oX----o--------------o----BB?M-X-o---------M--o-----------------------XX------------X----------X--------X?o------X
XX-X-XXXX-XXXXXXX-X--XXXX-XX--X--XXXXXXXXXXXXX-XXXX-XXXXXX--X-XXXXXXXX-XXXXX--XXXX-X--XX-XXXXXXXXXXXXX-XXX--XXXX-XXX-XXXXXXXXXXXXXX-X-XXXXX-XXXXX-XX-XXX--X-X-X--XX-XX--XX-X--XXXXXX-XXXX-X-X-XXX-XXX-XX
