?------------------------------------------------------------------------------------------------------------------------------------------------------------------------------------------------------o
-------------------------------------------------------------------------------------------------------------------------------------------------------------------------------------------------------|
o-------------------------------------------------------------------------------------------------------------------------------------------------------------------------------------------------------
-------------------------------------------------------------------------------------------------------------------------------------------------------------------------------------------------------|
T------------------------------------------------------------------------------------------------------------------------------------------------------------------------------------------------------E
M-oMB----oo--oM-B-----B-?oo?M-M-MXoo-oB-?---?-B?----M???X?-o---oMMXBoooMXXB-?o--o-oB-Mo----B?o-oB-?X-oo-ooo-M--BX--B--X-Eo-BX-ooo?o-oM----M?oo-M-??MX--o-Bo-?o--oXM-oBX--?-?-XoM-o--?oooMMBB-oo-o?o-ooMT
oo-----BMBX?XX-o-XM--B-o-B?--Xo-oXoXB----B-B-M-ooo?--o--?--B--B?----XBo-B--B-B??-BB-?-M-XMo----?ooo?oXMoBX----?--------B?M?--oMM---BM--?-oo--M?-M---o-oBM-BX-MooBMo-Moo-Xoo---X-MM?X-XM?-o---BoMM--oBX-E
XM-o--?----oXB--oo-M---??----M-oo?o----MB-B-X---o--o-?oXoM---X-----oo-?o----o--ooo-o-B-o-oX---o--XB-M----MX--E-Mo-?-M?oo----o---?--o--M-o-oM--oM-oM-?M-o-ooXo-Xo------?--M-oX-o----XX--oBoo------?o--?-v
X-------Xo--B-------oBM--?BM---B----o---o--M?oo-MM??--MX-----o---?ooM--M--?o--o-M-ooB-o-?-XM-X??------B-?oBM??B-X--Bo-B-o---BB-Bo??----?XX---Xo-ooo---o--oo-ooMoM?o-oB-?X-M-XoB-X--?--MMo--B-?o--o--B-M?
T-MBM--------MXo-ooMB--?---oB----??-MB---o---M?oo---Bo-XB?-o--X?M-B?-XX---oX-?MX-MMMo--ooM?oBo--?oo-o-o-oMo--?-ooB?oo---M-oMo------MX?M-oM--MoX--B?oMB??ooo?o?-o-o?MBo--oo--M--B-oooo----oo---o---M----o
oo---B-X-o--o-oM--------oo----oMM--X--o?Xo-BM---Eo---oo?--o-o-o--M--o-X-oo------E--oMMo?---oo?-o--Bo-M-B----ooo-B--ooo-M-BM---oM-o--Bo-?--X--M?oM-o--o--BBB-?-oo-?---B--BM---Bo--X---?Bo-oBMo-o?B-oX?-oM
oM-MX--BX?-B?oBo-X-M-o--?oB?--Bo-o-B-----o-o-MBM?X-o?B?-oM?-?MoMo-MMMoo-MBX-B?o-X-----B-?B-BM---?--Mo-?-?--oX--XoXoBB--------MM--MoB-o--o-M-oo-M----oXoB-----Boo-o-oo--B--oo?-ooX-ooo-o-oo--M---oB-B-??X
M----o?o---o-X-X-XX-M----o----oB-M---oooEB?-----o---------o--oMoo----MBM-o-?o--o-----M----o---?X--o-?o-M-o--MXoEo-X-----MB?--o-??-M--o?-X--X-o--?o--M-ooB------MXM--B--o-X---oX-MM--?o-X-Xo----E--X----T
o-oEo------o-----oo---oo-oooT---X--o-X-Xo----oo-----------oXoX--oo---oooo------T--X--o-o--o-XX------oXo---o-o-???---XXoo----T-------X---o--X--------o-Xo--o---o---------oo-----Xoo--o--oX--o-BB?B---oo-E
?--XoX-----X-o---oooo-o--Xo-|-X--oo--o---o-o-X----o-ooo---o-o---X----o-o-oo-oo-|o--o-ooo-oo-o-oo---oXX--o-o--oX---o----ooo-X|o-o--oo----o-o----o-Xo-o--o-X-o-----X---ooo----oooX-ooo---oX-ooo---ooo-Xo-?
XXXXXXXXXXXXXXXXXXXXXXXXXXXXXXXXXXXXXXXXXXXXXXXXXXXXXXXXXXXXXXXXXXXXXXXXXXXXXXXXXXXXXXXXXXXXXXXXXXXXXXXXXXXXXXXXXXXXXXXXXXXXXXXXXXXXXXXXXXXXXXXXXXXXXXXXXXXXXXXXXXXXXXXXXXXXXXXXXXXXXXXXXXXXXXXXXXXXXXXX
