------------------M-----------------------------------------M-------o----------o----X---------o-o--------------------------------------M--------o--------M-o--------------------------------------XM----
-----------------------------------o----M----------------------------M------------------------------MM--o---------------------------------------M-------------------X-X--M------------------------------
-----X---o------------------------------------------M---------------------------------------------------------------------------------------------------------M-----------------------------------------
-----------M---------------------------------------------------------------------------o---------------------M-------------------------------o-X--------------------------------------------------------
----------------------------------------------------------------------------o-----------------------------o----------------------------------------------------------o----------------------------------
---MX-o---M-?X-?M?MEMo?X-M?X?BMM-BM--XX-?Xoo??-B-?X??-M?XB----Xo--?--M---X?----?B?--o--BBX-??M--XXB?X-XoBBX-?B-X-?X-XX---BX---?---M----M--?o-B---X?X--?MMX-Bo--M-X?---B-X-----BB--MoX-B-?XXB---MX----MM-
------XX--o---ooo--Mooo--B-B---o?o---?X--BB---?---M--MB-T---Xo?M?--------BoX-X----?---B--------XB-o--B-B---B--Bo---MBX--B-B----M-o-----o-X----X?B--?--o--M?-?-M-X--XE--M-?MBMX-----B--X?--o-?oo---B?--o-
--?--M-----M-?-XM---?--M---oM--o-?M-----X--------B-----X|X--o----o-?--?-o------M-?o?----BXB------MMo--Xoo?--??-Mooo---o-o---BMM-o?-X-X---?-X?-M-o---E?BM-oo--XBE---XX---M--o-------o-----Xo-o----Mo-?-Xv
-M--?o-X----X--X---?-X---BM--XoBoo-M-------X?-B---?-----XX-BX?---X-XX--o-?--BX----B-XMX------MM----X-XX??-X?o-----MB?oB--BMooo----?B----ooM----M-X-??o-o-M--M-?B-B---B-o--?XB---B-M-?---B-E?----oMX----f
---o-Mo---B?-XMM?-o---BB--?-?X--B----Bo?--?-o?----MX----BX-o--------o-BM--oM-XMMX---oo??-?--Xo-?-XM-oM-o-?---M-B--------o----?----o---X----------o--X-B?M----M-MM-??-o?-----oM-------?X--?M----Bo--MMXBf
---?---oB---MM-oM--BB--------XM--M?---?o-?-?M-X--?---------XX-----XMB---XM--o?----X-----X-???--o---?---o--------XX--X-oo------B------BoB-o-?-Mo--?X-----oo-E--o--?--X---?--?----------B--M--B-----o--?-f
-?---o-o-o-----oXX-----?B-B-----M--M---X?o---B----M----MMXXMMX--XB-----o----?--M-M-----B-o---?MX--X-X-XMMoB-X?XMX-MX-E---?-X---o---o-----M------B----B?-XBXXXBM-M-X-M?---X--o-----------------oE-?o----f
-o?oX-Bo--MX-----M---M----o--B--o----oMB-XB-oo-XX-o--M--?M---B-----XX-o-XB?X---------MM-----?--MXXo-BX-o--oo------o---X-B-----B?B-XB--BX--XXX-oM-XX-E--o-o--X----?MB------?-B-XMM-Bo-M-----o--oB------Bf
-----------o------------o-----o------X----------M-----o----o-----T-oT-X----------X-------X----o--Xo----------o---o-------Xo-X-----o------o--M-------X--o---oXo--o---------------------X--------X---T---f
m------------o--------X-----oX------X--------X--o------o-----X-X-|X-|--------oo------o--X---oX------------oX------XXXX---o-XXM-Xo----X---o------X-X----X--o-------------o------XX---oo--------o--X-|--oX
XXXX-XXXXX-X-XX-X-XXXXXXXXoXXX-XXMX--XXXXX-XXX-XX-XX-XXXXXX--XXX-XXXXXXXXXXXX-XXXXXXXX-X-XXoXXX-X--X--X-X-XX--X-X--XX-X--XX--XXX-X-XXXXXX--Xo-XXXXXXXXX-XXXXX-XXXX-XXXXXXX--XX-XX-XX-XXX-XXXXXXXX--XX-XX
