--------------------M-------------------------------------------------------------------------------o---------------------------------------------------------------------------------------------------
--------------------------------------------------------------------------------------------------------------------------------------------------------------------------------------------------------
------------X-----------------M-------------------------------------------------------o-----------------------------------------------------------------------------------------------------------------
--------------------------------------------------------------------------------------------------------------------------------------------------------------------------------------------------------
------------------------------------------X-------------------------------------------------------------------------------------------------------------------------------------------------------------
----?---M-BoX--------X--?M?B-M--XTB---BX--X-MB---M---M---X---?XB-?M-X------?X---?MM?-MB-B------B-X-?------o???-----B-?-?-BMM--BX----M-?---?M-X-M--BX?------BMMX-B?-?-BX-M-------X--?-X?-?--?M---?---XBX-
-----X-BoB-?B---MMBMX-----ooB---M|--XX-------oo-------??BB----X-?--?----M-B--?---------B---BX-B-BX?-X?----o----XXBMoB-X---o----X-?-Xo?--X?--??M-BM----M-----o----o--X--?-X-MMB---B---MoMoBM--B--o--B----
-------o?----?--------?--B-B--?--X---M-?--B---B---X--X----o--?-?o--o-XXX-XoT----B?-X?-?------B---------M-X-M--MBX-oooM---X--MX--B-----MBo------?---BX?---X-M--?---M--X--X?M-o-M-?o--M-X-M-o-X-B-M?M-MX?v
-XBB--B-----o--?-?B-----o-?------?BoX---Moo-MX------?BBE--MX?-M-B-?--?----BX--o------M---M?B---M--M-?M-----oX----MB--o?B---M------BM-----B------B?--M-?B?-X----XX-oo-------X----o----??XoBB-MX--o-o--B-f
---------?--BMX--o--?-B-MX-X-----o--BM-------B---o-M----MM----o---o-XX-BM----?-------oM?---o--?o-BXo--BX----M-M-----?---?-B-M?-M---------o----------o-oo---o?---??--BX--B----?--XBX-?-----o---?--B-X---f
-?-o------B---X---------o-M-?-----?--o--------B----o--------X--B--?---B---MM-oXM-?---B-o--X--M--B---o------?-B-MX-?--M-------oM-----X----MBX-MBM----?MB-B-MB-M-X---X---?o--XM---o-?-------BXXX----B--X-f
-o-X----??-----B---X?XBXBXo-oB-o--oo-XXo-X-M?--X-?-MMM-M---X----BX---B--------X--o-------M-----X--B-BM-XX?---oM-?M----?M?----Mo-o-----M?----Bo-----X-o---?----?M-----M---X?B----?o-M-M---M----B-----B--f
---M--M-o-E?----X--?-X-----X--BX-X--B--M---------o------?X-XMM?------o---------?-oB-?-M?-o----B-------?---?----B-o-------X?--?B?-o--M---?B-------?---B---o-----o---MXoE--B---X-------oM-X-----oX---M--Xf
----------B-T-----X-------X-o--------X---------X------XX-----o---------XT------o-oo------oX-Xoo------o-------------X------o-------------------X-------X-----------E---X----o-XX-------o---X------------f
m-----------XX--X----X-----------B----X--------X------X----XX---X----X-X|---XX---------------X----------------------------X-----o-----X------X----X------MX-------?-o-----M-X---X-X-MXMB-X-------------X
XXXX-XXXoX--XXXX-X-XXXXXXX-XX--XXXXXX-XX-X-XXXXXXXX--XX-XX-XX-XX--XXXX-XX-XXXX----X--X-XX-XXXXXXXXXX--X-X-XXX-XX-XXX--XXXXX-X-XXXXXXX-XXX--XX--XXXX-XXXX-XXX-XXXX--XXXX--X--X--XXX-XX-X-X--XXXXXX-X--X-X
