?-------------------------------------------------------------------------------------------------------------------------------------------------------------------------------------------------------
?------------------------------------------------------------------------------------------------------------------------------------------------------------------------------------------------------?
X------------------------------------------------------------------------------------------------------------------------------------------------------------------------------------------------------|
X------------------------------------------------------------------------------------------------------------------------------------------------------------------------------------------------------X
E-------------------------------------------------------------------------------------------------------------------------------------------------------------------------------------------------------
E-Xo-XE?oME?MXo-oo-X?EE--?XoooX-?M?Mo----Xo?--Mo--?XMX-?E?MXEB--EMEMB-E-EMXBBBX-----E?---BM-EBoB---B?-BE?MoXMBMoEXMo?X-XXEXo-XBoEooX-E-o--X-MEM-BXBM--M-oX?-E-M-X-M-BM-EEXo-oo?XoXEXoo-M?o-oo-EoMMoB-Boo
TMMBM-o?BXMBEooXB-?-??X?-BoBBB??-----EEXM-o---MXB--EMXo---oBoM-MBB-?o-E-??oo---o-BoB?Mo-?X?---o-o-o-EoB---MEXEEo-EoE----oo-Mo--B?X-oM--X-BMM?XXEoME-E?-o---?oE-MooBBE-oo?M---BM-o?XMEo?-M--EX-M--E-Xo--?
--o-XEo--oo?oo?BoXo??Eo?-?M-XEMME--Bo?X--Bo--BBB?EX?MMBEB?Eo?E?-o-?MXM-XXXoXEMB------Moo--o-o-MEEoE-XMX-X??BBEXBM--EM?----B?MoX-MBB---o?o-?Boo-M?E--BMB?oM-X-oEXB??B-MMX-BE-E?-X------X-X-oM??BoEMXMoB-v
?B-BEXMBB-BXoX-oXo----oMM--EoB-oXX---BMB-B-BX-M-???MXXE-EB-??--MEooMEMB-?E-M?X?o--oM-o--MB-XBM?BoMB---BEEoo---BBBo---BX-o-B-?Bo---Eo-X--o---?-X-EMB?MM--?-oBEM----XoEX-MEM--B-XooEBMBB-?-BBX-?XoB-ME-XX-
|ooBEEMoMEMM-?B---oM?-oM?--BMXB-?-B-B?o?EoE-o--XM?-ooo?-E-B--EBEo?-?o-oBB-oXo?MXo-MXXXBMooX?-E?-o?M-Mo--oEE?ooo-ooM-o-?BEXX--BoEX-o-o-E?oE-X-EooBB-??-EBB?-MoEoB-X----XM-Mo-B--o?MMXoBoBoE?M?-E---?BMBoM
EB--oBBX-X-BM?---EXoM-o-BBo?XoB-X--Xoo-XE-XEX-oM-o-E-B?-E?-BMBEX-XoMX?oEB-Xo--oME--EBXXM-B-MX-?XoX--oo?Bo-XEX-EXB-o-?E---MB?Xo?X----B-XX-XM-E?EXX-o-?M?BX--BMEEo-EMMEo-M-?EBoBoo-ME-B-?MoBEXME--?E-EXoB-
?--X-BBXEMo-o--?--oBoXMoo-?-MBBE-MB??-oBEMBB?oM?XE-E-BBBEEBEE?BM?Eo---?MME-EMoBMo?MX--?B-B---EoM-BXMXXEMoEEEEoX--ME?B--?EEE-X-?--oX-XXo-B-MBXB--B-o---M-ooEXBE---oXMoooo-BE-EEXXMMMooME-o-M--EX-BBo-BMXB
MXB-?oBB-oMoEooB-XX-oXXEBE?Xoo-B--BooBEX-oMB---o-?-oo--oB-X???o-?M-oBo--BoBoXM--BMXBE?-XEXBMM?o-Xo-MEo-XBo?M?X-BoM-Mo?-XooM?Mo-M?-oMXE-ooEEMX?B----oMo?BEE-?-X-?oMB-BBE-?o-XoX-Xo?MXX-EB-MBMEEBXM--BEBEo
X--oEBBoE--?-X?XoX-B-B-XBXBBX--XX---oooXoXXB---EBo--oBB?oB?ooXo-XB-?--oo?o--oB-X-X---B?XXX-Bo--o-EEo-o----E----oX-Bo?E?---o---oXoEBBoBoooEEBBB-Xo??-X?EXB----EB-o--o-o???---BBX-?EoXoBo--?Bo?--oBo-Xo---
m-E?-oE-B?X?BEX--?---o?o?X-Bo--?o-?oXBoo--BX--B?XooEoo--EEoB-BoB---E-o---XE--ooo-oXX-XXBB--?---E--B--?X-?-----X-?X??--o-Bo--o--B?-X-EX-E---o-??oEBXX-oB--B-BE--EoXoEX-X-Xo--?Bo?-o---Xooo?X-E??B--B?-BoT
XXXXXXXXXXXXXXXXXXXXXXXXXXXXXXXXXXXXXXXXXXXXXXXXXXXXXXXXXXXXXXXXXXXXXXXXXXXXXXXXXXXXXXXXXXXXXXXXXXXXXXXXXXXXXXXXXXXXXXXXXXXXXXXXXXXXXXXXXXXXXXXXXXXXXXXXXXXXXXXXXXXXXXXXXXXXXXXXXXXXXXXXXXXXXXXXXXXXXXXX
