o-------------------------------------------------------------------------------------------------------------------------------------------------------------------------------------------------------
?------------------------------------------------------------------------------------------------------------------------------------------------------------------------------------------------------|
|------------------------------------------------------------------------------------------------------------------------------------------------------------------------------------------------------T
?------------------------------------------------------------------------------------------------------------------------------------------------------------------------------------------------------|
X------------------------------------------------------------------------------------------------------------------------------------------------------------------------------------------------------o
E-o?-?B--Bo?-X--X?--E-?BBoB-M--M-------?-B?--?o--BoMo?B-o?B-o-BB?M-BMX-EooM-Bo?----M-ME-MB-X?oBMMoMoM-B--?o-XMo-o-?--oB-MM-X-?BMM?Mo?--Xo-MX-MBB-X-M?oX?M-BB?-?-X--o-oMX-o---oBBo--MXB-oM-o-oBo-----oBB?
??ooo---o------o---o?-o--|---o?--oBo?---o--o----X-?o?--X-o-?o--------Bo?Xo--o--MBB--???oo-oX-?---MoX-o-Bo-B??-oEM-------o---o-o----BoX?BB--o----B-o-oMM-o----o-o---X-MoMoB?-oM--Xo--X-----X?--B-MM-?---T
?--MXoo-MB-o-Moo---oXB?-oXMMoBooEX-?oM--M-o?---?oX-B--Bo-------o-MM---M?oB-o-o---o?B-TBo---?--B--BM--ME-?o--oX?X-EMo--M-oM--X?-?--Xo---o-?-BB--o-Mooo---T--o?---X-Xo----M---M--?X--oEX?o--B--o----X-BX?v
XM?oMo-?----?-Xo--EXB--ooM--M-ooXBB-o-Bo-o-oo----X-o?--B-?--oo-Mo---?---o-X?BMM-o----|-?-?BooMoB--Xo-X?---X----o-?-oX--MM-XM------oo------?oo-oo---MMBBB|MMM-o--B-M?-o-?-X-o--M-?oMBBX-oX--oB?MMo-M----T
B-o--?Mo-o---oBMoXB-oM--X---oooooo--BX--?M--X-X?-MoB-?--o-oXMBB-B-oM--o---?o----T---oX?-?---ooo-o??M-oMXXE--E--X-o?---?--M-oB-Xo-MX-?o-BX?--o-?MX-?o----X------XoX----BoE?-oXoo----M-o--o?-B--?-XB-o-o?-
?-BBX--oM?BoBM---oMo----E-------XMo--oo----?--ooB-M----?-o?o---B-----oo-o---oM-E|o?-MB------X---B--o?M--oMB-B?E?-B-o---?ooM---BMX-M?-BX-o-XoBo-o--o--M-oo-B|o-oXo-oM---BB--?-oXo-?o-B?MMooB-X-M?B--o-Mo|
|B-o-o-M------oXoB-BB?XBX?-X-?---oXM-o-o?Bo-B-M-o--BB?--o?---o--o-M?oM---XB?oB-XXX-M-o-X--ooEM-B--o-oo-?X-o-MMXoo-EB|-o-X---oo------?-E--X?ooBooEEX---X-XEoXXB--X-?-?B-M-?--oB??--?-o---B--EB-o-o-M?-ooM
-ooX--M--B-M--?o-oM---BB--?-Xo--o-?--B-Xo-o--o--B??-----?-o-?----Bo-M--oX---?--o-MM-X--?-??oM--o--oXB----|oXEo??-XXoX-?-XM--X?B?B?-oooM----X---BXXB-oX---??M--B-------X---E?o--ooo-------E??ooMo-o--MX??
----oE----Xooo--Eo--o------o--o----Xo---o--BBo-o-oo-X-o----o--E------oo--X-o--oo----o---Xo-XX-ooo-oo-----XTXM----X-----Xo--o---o--o--o--o----E----------o---XX---oXX-----XB-Xo----EX---???MX-E--??M?-ooE
m---XM----oooo??X?---o-|oXoXoXo-Xo----o------|-ooo-o------o-XoB--oXoXo----oXX-----oX--oo--ooXXooo-X--o-X-X|XX-o--oX-o--Xoo|o-----o--oo|o--X|oM----oXoX---o-Xo-X-oooo-oo-ooX|-o--MBMB-|-BX-o--?---o-----|
XXXXXXXXXXXXXXXXXXXXXXXXXXXXXXXXXXXXXXXXXXXXXXXXXXXXXXXXXXXXXXXXXXXXXXXXXXXXXXXXXXXXXXXXXXXXXXXXXXXXXXXXXXXXXXXXXXXXXXXXXXXXXXXXXXXXXXXXXXXXXXXXXXXXXXXXXXXXXXXXXXXXXXXXXXXXXXXXXXXXXXXXXXXXXXXXXXXXXXXX
