---------------------------------------M-M--------------------o--XX-----------o-----------------------------X-------------------o-----------------------------------------------------------------------
----------------------o-------------------o----------------------X-----------------------------------------------o------------M--------------------X---------------o------------------------------------
-------------------------------------X--------o---------------------------------------------------------M-----o--o------------------------------------o----o--o-----------------------------------------
-----------------------------------------------------------------------------X------------------------------------------------------M-----o-------------------------------------M-----------------------
----------------X------------------o-o-----M-X-------------------------X--------------------M-----------------------------------------------------------o------------X-------o--------------------------
---MX-----M-?X-?M?M-M-?XT-?X?BMM-XM--XX-?---??-B-?X?o--?XB----XM-o?--M-M--?o---MB?---B-BoX-??M---XB?--X-BBX-?B-XM?X--o-X-BX---?---o?-E-o--?X-B----?X--?MMM-B---M-X?---B-X-----BB-XMoM-B-?XXBM--MX----MM-
------XX------o--------o|B-B----?o---?XM-BB---?--oMo-MM-To--X-?-?----o-M-B-M-?oo-----oB--------XB----B-B---B--B-o--MBXX-B-BM-----E--B?BMoXo---X?B-oo---o-MX--o--X--X--o--?MB-X----oB---?--?---o---B?----
--?E--o----M-?-XM---oX-MX---?----??-----X----o---B-----X|X---------?--?MM--XM-B-M?-?----B-B------MMo--X--?-o??-MB----oo-o--oBMM--XXX-o-oM?--?-M-o---E?BM-o-B-XB----B----M---o--XX?-------X-o-----B--?-Xv
-BB?B-MXo---Xo-X-----o-o-----X-B-ooM--o----X?XB-Bo------XX-BXM---X--X-M--?--oo----B-XXX-o----M-X-ooXXXX---X-----o?B-?XM--oM---o--X-B----o-M-o-oX-Mo?X----X--M--o-B---B-?--?XB-o-B-M-?-X-B--?-?--?o--o--f
----oM----B?-XMM?-?---B---?-?X-------B----?--?X----XX---BX--o-------E-B----M-XMMo---?-??-X---o---X--oM---?---M-B-----Mo----M-X--------M--?-------X----B?MB---M-MM-o?--?-o----Mo--o---oXM-?o----Bo--MM-Bf
--?----?B---MM----oBB-o------XMM-M?---?--?-?M--M??-------XXX------XM?--BXM--o?----Xo----oo???-----------o-M-----X---oX--------B-o----B-B---?-MM--?X-o---o-o-E---o?-oX-o-?o-?-------B--B-----B-----oo-?-f
-?-B-B---BX--o--X--o---?B-o-----M-oM---X?----Bo---M------X--X---XB----------?--o----BB-BM---o?MX---BXXX-MMo--XXMX-MX-E---XXX--oo---o-----X---M-oB---BB?-XBBMXBM-M-X-MX--XX---M--------o---oB-?--X??----f
-----oB---MX-----Mo--M--o----B-------?-B-XB----XMMo-MM--?M-BXB------XoX-X-?X-----oo---M---XX?-oMXXM-B-EM-o-o---o---B--XMB------?o-oB--BX--oXX-MM-XXM---?-o--o--X-?MB----E-?-B-EMM?B--M------------o-X-Bf
----o-o-----------X--o-o--o--------E-o-----------o--o---o---E----T-XT-X----------X-------X-o-----X-X-o?---------------------X---o-----M---o----oo------o---------------X?-----?o-oo--oX------------T---f
m-----oo--o----o--o-o-X------X---BMBB--------Xo---o---o-o---BX-X-|X-|----M-----------o--X---XX-----------o-X--o---XoXX-----XX--X-----X-oo?------X-X------------Moo----------------o-o--o---------X-|--oX
X-XXXXXX-XXXXXXXXXXX--X--XX--XXXXXXXXX--XXXXXX--XX-XXX-XXX-X-XX-XX-XoXX-XX-X-XXXXXXXX--XXXXXMoXX-XXXXXX-XXXXX-MXXXXXX-XXX--XXXX-XXX-XXXX--XX--X-XXXX-XM-XX-XXoXXXXXXXo-XXXX-XXX-XX-XXX-XX-X-XXXXXXXXX-XX
