T-------------------------------------------------------------------------------------------------------------------------------------------------------------------------------------------------------
X------------------------------------------------------------------------------------------------------------------------------------------------------------------------------------------------------?
M------------------------------------------------------------------------------------------------------------------------------------------------------------------------------------------------------?
X------------------------------------------------------------------------------------------------------------------------------------------------------------------------------------------------------|
|------------------------------------------------------------------------------------------------------------------------------------------------------------------------------------------------------B
XBoE?-?--MoBBE-M?M-BMXB-B---?Mo----?o?MB?--oBMX-oXo-MoB?o?XB-B--E-oEM-X?-o-B?B-?T-XBB-BM-EoX-M-XXoM?E?o-XMoBB-o?M-XBEo-M-?-MBoB?Bo-XB--o-o?o?E-M-MEBoMoBo?BXoo-X-M-oBXo-Xo?B???-X----?o-?-B?B-M?Mo--MM-T
--BB-?--B--BBMX---?----B--M?--?X--B-M----o-X--o----M-o--M-M-o-?BBBMX-o---M------|o---B--MBXB--oM?--XX--o-----M---o??BM?---o--X---X?o--o?E--BX?o-M?B-?-o-?--oM??-M----XB--X-----BBB-oM-?B---------?-M--?T
M--B---X--Xo--M-Xo---o-------o-oo--X-oM?BM--B-B?o?o--M---o-oB-----MBoMMB----BB--XMXM?-oMB---?BB-----|?o?o-o-?-XoM-X-?---o-BB--o------B?B?B----XB-----B-----o---o--MB----XXo--o----M?----X?M--oo---M-M--v
M---o--M--oMMX???M-o?BX-BoXB--o-M-M-XB-BoX-E----------BB-?B----Moo--o---BBoX--?-o-X--??----o-----o--X-o---BB--BX-oMo-?-Boo--oX?-XB-oo-M-M-X-oMo-M-oBX-?B-BXM?--Xo----o--Mo-X-?---X--BoE----?-MoX-?-M-Xo|
M-X-oo--ooB----E---?--E--oo-M-BX-E-?--M-MMXM-Bo-B?--?---B---o-o-?M--o--X--X--B----X------Mo?-??B-oB----o-----o--o?-X-----o-BMo-Bo------o-?----oo-Eo-oM----B---oo---M-XBM-?-o---MM----MM--Xo-o-oX------E|
B??o?---?M-E-BMB-----?Xo-??--o-MMMo-M--B---o--Bo--?--BEX-?--B-M---o-X?-M---Mo--X--B-oB-B--o-X---XX----X-X-X--XoBo-XMMMBoEB?--B-----??-BXB--B--MMXBXoM---Mo-??-MM----B-----oXBM-----Bo----MB--E-M--oX-?XT
M--M-M----B?o-Mo?ooBMMXX-----M---B-M------?-M--MB---T-XBX----o-Bo?MMB-o-M-M-o--?Mo----B----X?B----E--B-XX?o------?o---BXB--o--?o-oo----o--E--o--X?B---XM-M---M----?---??o-M------oo-?-MB?--MBXB--X?B?-oX
Xo----?B?--M-M-M-oM---B?BXBo--o?----B-?o---------?BX|MX--Bo-BB--MB-B--M--?--Xoo--E-oo-----oB---M-?X-----B-BBo?-XX-B--XX-X--X-M-BMBXM-?-?X-B--o--o--M--o---oBB-MXE----o--X--B-----?M--M----M--BXXXX---o?T
TB--------X-X---X--o-------BB-?--o---B-o--ooX---o--?X-X-B--X---B--o-?---B--X-Xo--MoBBX----B---X-oXM-Xo-?--------?--?-X?XMBXBo-------?---o-|?-?X?X-E-----X-X----M?----?-Bo----XoEo--?--B-X--oB-XX-X---T-M
m-oBo-o?X|XX-o?Xo?-ooX--B-o--o---B-Bo--X-XXBoo--BoB-Xo-----B-oo-o----o-?-----o?--XB---oooo-X|--o-?-oXo---|o?|?o--X?-BB--X-B-B--o--o--?o?oBX---B-?BM--X---o----o|o-X-B-o-B-B?o?-XX??-BB-oo-Mo-X-X-oToo|-M
X-X-XXX-XXXXXX-XX-XXXXXX-XXXXXXXX-X-XXXXXXX-XXXX-X--XXXXX-X-XXXXXXXXXXX--XXXXX-XXX-X-XXXXXXXXXXXX-XXXXX-XXX-X-XXXX-X---XXX-X-XXXXXX-X-X-X-XXXX----X-XXXXXXXX-XXXXXXX--XX-X--X-XXX--X--XXXXXXXXXXXXXXXXXX
