?------------------------------------------------------------------------------------------------------------------------------------------------------------------------------------------------------X
o------------------------------------------------------------------------------------------------------------------------------------------------------------------------------------------------------M
|------------------------------------------------------------------------------------------------------------------------------------------------------------------------------------------------------|
M------------------------------------------------------------------------------------------------------------------------------------------------------------------------------------------------------|
B------------------------------------------------------------------------------------------------------------------------------------------------------------------------------------------------------?
M----?-?--?-?BB-oM?oo---------BoX-X-BX-oo--M?MBoXoTo--B--oBXMBM??--o-MM--M-Boo?XXM-MB--B-Mo--Bo?oMo--MM--M?--M-XoXX?-o-----M?-o-?o-M--B-X-B?BX-Xo-oXXB-oX----BooX-MXXoMB-oMoX-B--MoTo-MooBB--X-?--ooBB-X
|M-Xo-o-X--X----X--??XMo---XX?-Mo----BMM?M?----M-o|B---oXX-X-----o-XX--oX-X-X--?B----X?-M-BXB-B-X-o-?--o---Mo-B-----MXoXMX-----?-----B-Xo?----oXXo--o-?---o---?M---M----M?--X?-oM-M|---??--BMM--X-oM--BM
M--BB-o-?M-B-X-o?Xo--o-ooXo-X-o--o-------?---Xo-o-X-M-?B-Xoooo--Bo?-?o-----B-o---oM--?-M--------o-----BMoMX-B--B-oB?-oMX--BMBM--B-XXX-oX--?--?-M-----o--B-M-?-------o-o?----X----X-X-MM--o----?B--B--X-v
o??--XoB--B--oo---o--?-XXXoMM?-Boo--o-X-B--XM-E----o-M--oo-oB?B--M-o-?MM--?-B-oo-o-oB-o--Xo--?-??-M-Bo--B-B--Bo-?X---X-M---------?B-o-XoMB--B-----X-BoX---------Bo-?-MX---B-?-ME-?-?o---XM-M--------o--E
?---???-oM--o--B-oBMo-M?XB?---?-B?-XoMBo---XM?MXoM-X-----M??-M-M--oM-----?-X-?XB--X?-o-oBXo---o----o-------?B--M--XBXMB-X--Bo-?-X---X---------o----o---oM-BM---X-??-o-o------o-?--M-oX----X-o---MoMoMB-T
M--B---o---B?B---M--B---M------M--Bo---Mo-oo--XXX----Mo-------o-?-?---o-?-?B----ooM-M?Xo-M?---X-o-Bo----oXB---------B---X?--M--E-?-?B-oEooBM-?XBXoo-X-MB-o---M-B---?B-??---oEo------?---M?-B---?-B----o|
-?--oBoXooB---o---o?-BoB---M--M--o-XB-o-B-o--X?M--B---M--o---BX--B--??X------B--B?----?----XBMo-M?--XoM-Xo-o--?BMoM--X--X-X--M?XM----MMMMM--?-B-ooMXXM--BBoo--X---B------X?XBBMoo----oB---?-o?----?M-o-E
o--BB---B?-XB?o---X-X-?-B----B--o?o--?o--B??-X-----oX--?-oo-?---?-----?--o-M?--?--o?-?-o---B--BM----X?-----------M-M---?MBX--------o------------o?--------?BM--------oBoXBMM---Moo-o-M---M----B-o----?-X
ooo--?B---BB--?o-oo-oX---X----X-B-BBX-B-----X--BX-XBX----BBB--o----------B---oB--XX---oB?-T--------Xo-o-o----B--X-T-B--------B?B-BX?--BXo-o----oB-Boo??X------------To-BoX-------o--?-??----X------T----
mo?-o---XB-----oooB-o-Xoo??-o--B----BB-oo-X-?-o-BX--B?-------?o--X?o-------?oX-BoXXo--o--B|X-|--?-o-MBB|?o-oo--oB-|--?oo-oXXo---X---X--Bo--X?-oX-o-??--XB-o-oo-oo---|X--Xo--o-B-?Xoo-X-----oo-B---o|---E
XX-XXXXXX--XXX-XXX-XXXXXX--XX-X--XXX--XXXXXX-XXX-XXX--XXXXXXX-XXXX-XXXXXXXX-XX--XXXXXXXXX-XX-XXX-XXXX--X-XXXXXXX-XXXX-XXXXXXXXX-X-XXXXX-XXXX-XXX-XX--XXX-XXXXXXXXXXXXXXXXXXXXX---XXX-XXXXXXXXX-XXXXXXXXX
