-----------------------------------------------------o---------------------------X--------------------------------------X-------------------------------------------------------------------------------
--------------M---M----------------------------------------------oM----------------------------------------o-------------------------------o---------o----------X--------o--------M----------o----------
---o-------------------o-------------o----------------------------------o-------------------o--------X--------------X-------------------------------------------------------------o------------------o--
------X-------------------------------------------o------X---------------------------------o-------------------MM---o-----------------------M------------------------------------o---------------oM-----
---------o--------------------M-----------------------------o-----------------------------------------M-----------------------------o-------------------------------------------------------------------
---MX-----M--X-?M?MoM??-T-?X?BMM-BM--XX-?---??-B-?X??-o?X----MXM--?--M--o-?----oB?--XB-oBX-?-M---XX?--X-BBX-?B-XM?X------BX---?---M?-o-o--?X-----X?Xo-?MMX-B---M-X?---BoX-----BB-XMEMoB-?-XB---MX---oMM-
--oo--oX--o----oo-o-o---|B-BMo-oo-----X--BBX-o?------MB-T---X-?-?----o-o-Bo--?-oo-?---B------o-XB----BoB---M--B----MB---B-B----M---o-BMM-X----X?---?X----MXoX---X--Xo--?-?MBMX---o-B---?--?o?-M---B?----
--?----X---M-?-X------oMX--o?--?-??----o--o--o---B-----X|X---------M--BBM----o-M-M-------X-------MMoM----?--??-MXo-----------MM-B-XX---o-?--?BMoo-ooX?BM--MB-XBo---BX---M----oBXX-oM-----X------oB--?-Ev
-?--M-M-----X--X---?-X---oo--X--oo-M-oo---o-?XB-B-?M---XXo-BX-X--X-oX--o-?--BX----B-XXX------Mo--X-?B-X?ooX?-o--BXBB?X---BM----X-B?B------Mo----M-MMo-oo-X-ooM-oBB---B-?--?XB-o-B-M-?---B-o?-?--?-----?f
-o---M----B?-XXM?-?---BB-o?-XX--B----BoX--ooo?o----X--XMBXE---?-------B-o-Bo-XXMX---?-??-?-oX--?---------?---M-B-o----oM--o-M?---o----X--?o-o----X----B?MB--o----o??-o?------M------o?XM-?X--ooBo?-MMXBf
--oo--o?B----------B--------oXMM-M?------?-?Mo-M??--------?XX-----XMM---XMo--?----X----oX-???--o---o---o-------oB-?-X---------B-E----BMB---?-MM--?X-o-------o---o?o-X---?--?-------o--B-----B-----X--?-f
-?oB-B-ooXX-----X---o---B-B-----M--M--MX?----B----Mo---M-XX-?B--XB-o-o---o--?o----o-B--B-----?MX--X-XXXMMMB-M?XMX--X-ooM-XXXo--MB-----o--M------B-BMXX?-XBBX?BM-M-XoM-?--X--o----o------B?oB------?o---f
-o----BB--M?X---oM---M---X-----------?-B--B----XXM---M--?M-M-M----M?X?X-X--X------X--MM-----?--MMXM-BX---o-M-o-----B-?X-B------o--XB-MBX-o-MM-MM-XooE--?----X----?Mo------?-B--MM?----Xo-o-M---------XBf
---------------------X-------o-----o-o-------o---M-o-----oo-------o-T-X---------X--------Xo------X--o---------o----------X-----o------o--oM-o-------B--o--o--------o-------------oo---XooB--------MMX--f
m-------o-------------X------X---XXXX--------X---------Xo----X-X--X-|-M-----------------X---oX-o--------o--X------X-MX-----oX-MX-----X-o---Xo--MX-X---o-X-o---------------X-------o--------------X-----X
XXXXXX-Xo-X--XXX-oXXXXXXM--XXXX--XX-XX--XXXX-XXX-XXXXXXX-X--XXX-XXX-XX-X-XX-XX-XXXXXX--XX-XXX-XXXXX-XX-XXXXXXXXXXXo--XMXXXXXXXXXXXXX-X-X-XXXXX-X-XXX--X-XXXXXXXXXX-XXXXX-XXX-XXXXXXXMX--XX-X-X-X-XXX-X-X
