------------M---------------------------------------------------X-----------------o---M------------------------------------------------o----------------------------------------------------------------
--------------------------------------------------------------------------------------------------------------------------------------------------------------------------------------------------------
-----------X---------------o----------------------------------------------------------------------------------------------------------------------------------------------------------------------------
--------------------------------------------------------------------------------------------------------------------------------------------------------------------------------------------------------
------------------------------------------------------------------------------------------------------------------------------------------------------------------M-------------------------------------
-oM?M-----B-----X---Bo-?-M-X-----B---B?---o---M---BB----E-E-----B?-o-----?--B--XX-----oB-o-?XM---B-X---XX-?o--XM----------B-------E?--MB-------X?----?X-M-M-o-X?M----XM---X-X----?o----?---?----oB------
------oo----?-o--o-E-X---oB--------o-o-B---B-Xo-oX-----M?XX------o-o-o-----o-M---------oMB----M--o-?--------------M?---?----------M------?B----------o--o--ooMM-----X----X-----XX-X-o-----o--?-X-oM-EBX-
--------X-o--E--B-Mo--o------o?---MB--B-M------B--------o-o----------BEM--o?-o--M------------oo-o--o-----Mo--?-B-M-o--o--------B-EB--oo---o--X------X?XM-oM---o-B---------BB?--o---MM-X-------X---E-X--v
--??----M------o-B-----M-----B--X--------oo------B---o-B?-------------M--M------------?--MXB--------E----oM?B---E----M-----------Xoo--X-----XM-----B-?----o----------?----o--X-o--M------X-------BX----f
-X------o-----o?---X-o---------M---?---M--Mo-B--o--B----o-Eo--o-o-------o-B-B---o?o---o----o-B-M-B--X--?-X-------oX-o--o---MX--MB--------BB-ooBo--------X-----o------o---?-----X-o-------?--M--M--o-M--f
--------------Mo-X------o----Bo---Bo-X-----?-o-BX-?o----??B-----------?----o-o?E----------?---oo----X------X-o---XE---BX----?----o---o-------o--o-----B-BB----B--o------------o?-M---------------o----of
-X----------------------?X?X-o---X---o---E--------o--oM?o----MX------o----Mo------X---MMo--B----------XE----o----BXB?---------o-MX?-E--o--------X----o----E------M-B-oE--------o------MX--------??X----f
--BB-o-BEX-BMB?-M---Bo--------------o---XBM-M-?--o---M-----------M-----o---?-------X?-----?------oE-------E-M--Mo-------M-B-B?oXoB?XBX--E-----B-?-?------BB-------o--?B----BX-----?-o-------BB---oo---Bf
--o-X--BM---o------oo--??---o--------------------o-o----------X------Eo--------X----o-------o-----X-------X-o--------o--o-o------o---X--B---------------------------------------o----------------------f
m----------Xoo----oM----o--?-oo--------o--------o-----------------------------X-----X---o--XX-------o------------------------o---o------------o----X-------T-X------X-----X-----X-------X---o------oo--X
X-X-X--XXXXX--XXX-XXXXXXX-XX-XX-XXX-XX-XXXXXXXX-X-XX-X--XXXXX-X-X-X--XXXXXX-X-X-XX--X-XX--XXXX-X-X-XX-X-XXXX-XXXXXX-XXX-X--XX--XXXX-oX-XXXXXXXX--XXX-XXXXX-X-X-X--XX-XXXXXXX--XXXXX-XXX--XX-XXXXXXX--X-X
