----------------------------------------------------------------------------------------------------------------------o--o------------------------------------------------------------------------------
-------X----------------------------------------------------------------------------------------------------------------------------------------------o-------------------------------------------------
-----------------------------------------------o--------------------------------------------------------------o--------M--------------------------------------------------------------------------------
-------------------------------------------------------------------------------------------o------------------------------------------------------------------------------------------------------------
-------------------------------------------------------------------------------------o----------------o-------------------------------------------------------------------------------------------------
----?-o-M-BoX--------X--?-?B-M--o-B---BX--X-MB--oMB------X---?XB-?B-X------?X-o-?MM?--B-B------B-X-?------B???-----B-?-?-BMM--BX?---M-?----M-X-M--BX?-X----BMMX-B?-?-BX-M-------X--?--?-?--?M---?---XB--
----o?XM-Xo?----MMBMXB------B---M-o-XX-------oXMB------?BB----Xo?--?---MM-B--?X--------B----X-B-BX?-XXX?MX-----XXBMoB-XoX------X-?-X-?--X---??-oBM----M--o?-oo------Xo-?-X-MXB-B-B---M-M-BM--B----MB----
--------??---?----o--o?--B-BoB?--X---M-?-?B---Bo-----Xo--------------XX--X--o-M--X-X?-?------B------------MMo?MBX----M---B--MX--B------BBX---------BX?o--X-?--?M--MM-X--X?M---M-?---M-X-M-o-X---M---M-Xv
-XBBM-B--------?--B----------o---?--X---M---MXo----X?BM--X-X?BM-B-?--?----BX--o---------M-?B---M--X-BMM----o----oMB---?----Mo-----B-----oB------B?-oM-?B?-X---o-X--o-------X--------o??X-?--M-o?-----B-f
----o-o--?--BMX-----?-B-X--B--------BM-------B--M--M-o--MM--------o-X--BM----?-o------M?-o----?--B-M-oBXM?B-M-M-----?-oo?-Bo-?-M--o-------------------o-----?---??--BX?M?----?--B---?o-?o-?Bo-?--B-X-o-f
-?X-------B---X------?oM--Mo?-----?-----------B----------oMBX--B--?o--B---MM--XM-?--oBo---B--M--B--o---oo--?-B-MX----M--------M------?---MBX-MBM----X-B-B-MM-M-Xo--X-------XM-----?---X-M?--XX----B--X-f
-o-X----??-----B---X?-M-BXo--B--------X--M-M?----?-MMM-M--------B--M-B------M-X----------M-----X--B-XM-X-----oM-?MX---?M?-o----------oM?--ooB-o----XM----?-o--?M-----M---X?B--M----M-M--------B-M-o-B--f
---M--M----?---oX--?-X-----X--X--X--B--M--o------o-----o?X-XMM?-o----oX-------o?-M?-M--?------B-----B-?--??E---B------o-o-M-X?B?o---M-o-?B---B----X--B--------o----MXo---B---X---o-----o-------X---M--Xf
----------X-T-----Xo-----o--X--------X---------X------XX---------------XT-----X-----------o-X----X--o------M-------X---------oo--X--o---o---T-X------oX-o---------Eo---------XX-----------------------of
m-----------|X--X----X----------------X---o----X------X----XX--------X-X|---XXo-----------X---------------X----XX---X-----X-----X-----X-----|X----X-------XX-----??---------X---X-X------X-------------X
XXX--XX-XXX-X-X-XXXXXXXXXXXXXXXXXX--X-XX-XX--XX-XXXX-XXXXX-X-X-XXXXX--XXXX-XXXXXXXXXX-XXXXX--X--XXXXXXXXXX-X-XXXXXXXX-XXX-X-XXX-XXXXXX-X-X--X-XX-X-XXXXMXXX--XXXXXXXXX-XX--X--XXXXXXX-XXXXXXXXXXXXX--X-X
