?------------------------------------------------------------------------------------------------------------------------------------------------------------------------------------------------------o
-------------------------------------------------------------------------------------------------------------------------------------------------------------------------------------------------------|
o-------------------------------------------------------------------------------------------------------------------------------------------------------------------------------------------------------
-------------------------------------------------------------------------------------------------------------------------------------------------------------------------------------------------------|
T------------------------------------------------------------------------------------------------------------------------------------------------------------------------------------------------------E
M-oMB----oo-ooMoB-----B-?oo?M-M-MXoo--B-?---?-B?----M???X?-o---oMMXBoooMXXB-?o--o-oB-Mo---EB?o-oB-?X-oo-oo--M-oBXo-B--X--o-BX-ooo?--oM--ooM?-o-M-??MX--o-Bo-?o--oXM-oBX--?-?-XoM-o--?-ooMMBBooo-o?o-ooMT
oo-----BMMX?XX-B-XM--Boo-B?--X---X-XB----B-B-Moooo?----o?o-B--B?----XBo-B-oB-B??-BBo?-M-MMX----?-o-?-B?o-X----?-------oM-B?-EoMM---MM-MMB?---M?oM--oo--BMoBX-MooBM--M-ooX-o--oX-MM?B-XM?o--oMBoMM--oBX-E
XM-o--?o----XB--oo-M---??-o--MEoo?----oMBoB-X---o--o-?oX-M---X---o?oo-?o--------o--o-B-o--o---o--XB-o---o??M-o-Mo-?-M?--ooX?MMo-?-----o----M-o-MooM-?M-o-o-X---------o?o-M--XBo-----X---B--o---oo?oB-?M?
T---oo--Xo--Boo-----oX---?BM--BB----o------M?o?-MM-M--MX----oo---?-oM--M-o?-oXX???-oB---?-XM-X??----X-B-?----MM-X--B--o-o---oBoBo??o--o?XX-o-X---oo---o--oo-ooMoM?o--Bo?X-MoX-B-X--?-E?o-o-B-?oo-------?
T-MBM---o----MXMoooMB-??----Bo---?BM?B---o---M-o---o---XB?-oB-X?--oXoX-------?MX-oMM---o-M?-Bo-o?oo-o----M------oB?--MB-M-oM---o---MX?M-oM--MoX--B?oMB??ooo?o?-o-o?MB---oo--M--B-oo-o----Bo---B---M---oo
oooo-BBBBo-oo-oo--------o-o-o-oMMoo---o?X--BM-o--o---oo?--o-o---?M--o-X-ooo-------o-MMo?-o-o-?----Bo-M-B---o--ooB--Mo--MoBM--MMB?o--B--?--X--M?-M-o---o-BBB-?-ooo?oo-B--BM---B---X---?B---BM?--?B--X?--M
oM-MXo-B-?-B?oB--X-M-o--?-MoM-B--o-B---o---o-M-?-B-o?B?-oM?-o-oM---MMoooMBX-B?o-------Bo?B-BMo--?--Mo-?-??-XBo-X-Xo-B--o-----o---MoB-o-oo-MB---M-----XoB-----Boo-------B----B-BBX--oo---oo--M----o-B-??X
MoM--B?o-----X---X--M----o-B---B-M---ooo-o?-o---o------o----o-M-?----MBM-o-?-o-o----oM-o------?Xo-o-MooM----MXo---X-----M?oB--X---Mooo?-X----o--Mo??M-o-B--?---MXM--B-Eo-X----X-MM--?o-X-Xo-------X-o-oT
-o--oo----MX--o--oo--------o-o--Xo---X-?----oo--o----o--o-oXoX---o------o------T--X---------XX--oo---X---oo---o-X--oXXo-----T-----o-X---o--X-----E----X-------o--o---oB--------X-o-----oX-Eo-XX-----oo-E
m-X-oXo-oo-Xo-----ooo----Xo--oX--oo--o-ooo---X-o--o-oo---o-oo---X--o-----oo-oo-|o-----oo--o-o-oo---oXXo-o---XoXoB-o----o-o-X|--o--oo--o-o--o-----Xo-o----X-o--o--X---ooo----oo-X--oo-oooXXBMo---ooo-Xo-?
XXXXXXXXXXXXXXXXXXXXXXXXXXXXXXXXXXXXXXXXXXXXXXXXXXXXXXXXXXXXXXXXXXXXXXXXXXXXXXXXXXXXXXXXXXXXXXXXXXXXXXXXXXXXXXXXXXXXXXXXXXXXXXXXXXXXXXXXXXXXXXXXXXXXXXXXXXXXXXXXXXXXXXXXXXXXXXXXXXXXXXXXXXXXXXXXXXXXXXXX
