--------------------------------------------------------------------------------------------------------------------------------------------------------------------------------------------------------
--------------------------------------------------------------------------------------------------------------------------------------------------------------------------------------------------------
--------------------------------------------------------------------------------------------------------------------------------------------------------------------------------------------------------
--------------------------------------------------------------------------------------------------------------------------------------------------------------------------------------------------------
--------------------------------------------------------------------------------------------------------------------------------------------------------------------------------------------------------
-------------------------------------------------------------------------------------------------------------------------------------------------------------------------------------------------o------
----------------------------------------------------------------------------------------------------------------------------------------------------------------------------------o---------------------
-------------------------------------------------------------------------------------------------------------------------------X-----------------------------------------------------------------------v
------------------------------------------------------------------------------------------------------------------------------XX-----------------------------------------------------------------------f
-----------------------------------------------------------------------------------------------------------------------------XXX-----------------------------------------------------------------------f
----------------------------------------------------------------------------------------------------------------------------XXXX-----------------------------------------------------------------------f
---------------------------------------------------------------------------------------------------------------------------XXXXX-----------------------------------------------------------------------f
--------------------------------------------------------------------------------------------------------------------------XXXXXX-----------------------------------------------------------------------f
-------------------------------------------------------------------------------------------------------------------------XXXXXXX-----------------------------------------------------------------------f
m-----------------------------------------------------------------------------------------------------------------------XXXXXXXX-----------------------------------------------------------------------X
XXXXXXXXXXXXXXXXXXXXXXXXXXXXXXXXXXXXXXXXXXXXXXXXXXXXXXXXXXXXXXXXXXXXXXXXXXXXXXXXXXXXXXXXXXXXXXXXXXXXXXXXXXXXXXXXXXXXXXXXXXXXXXXXXXXX-------XXXXXXXXXXXXXXXXXXXXXXXXXXXXXXXXXXXXXXXXXXXXXXXXXXXXXXXXXXXXX
