E------------------------------------------------------------o-------------o----------------------------o--------------------------------o-------------------------o-------------------------------o--oT
E------o--------------------------------------------------------------------------------------------o-------------------------------------------------------------------------------------------------XX
T----o----------------------------------------------------------------------------------------------------------o-------------------------------------------------------------------------------------BX
o-------------------------------------o--------------------------o----------------------o---------------o---------------oo--------o-------------------------------------------------------------------M?
T--------------o--------------------------------------------------------------------------------------------o----------------------------------------------o------------------------------------------M|
-----B-E--X-B?--X---E---EX--?-------oX-o---E--o-E-----o?---oBX-----E?-X-E-B--------B-o-----?---?--oX---o---B--B--EMMM-B------BM---Xo-X-o--o--?EB--X-?-o--E----E-----o-M---M--Bo--B-EM-X-X--B--oo-E----XM
X?M-----?-X------B-E---XX--X---X-X----E--X?oE----?M----EE-X-?---E-----?-M-BB------E-Moo--BXMX--oX--Mo--o-----XEB--EB--oM--?M-?--o-o-----B-?--------oo-BX-E---?E-MX-MBo----?BX---o----MX-EMo--E-BXBE?-XoT
o---?o?--M-------??oB----oX--M-o--ooBoEE-o--E-o---ME-BoM--M---E--Eo?-?-M------o-o---E?------Eo-M-X-BE----o?E---?M---B--B--------?-X--BXB--M-X-----o--B--o---B--BX--oE---M-------------------oo---X----Mv
o------X----o-E-Bo--MX----?B-o-B-?-oX---??-?-oXM?-M---B-MM?-----X-----o-----o-B--B-----B--M-----M---oX---?EX-?-----E-----X---?------XX-M---?-o--B--?--E-----ME-EoBoMMX-BX--o-?---o-E--B-M-?----o---EX-??
o-EoX-XE--oE-Mo--XE-----------oME---?Bo----B-----EB?----E-B----E-----o?-------oX-----M-M----?-Xo-o-------X-E-M----E------B-?-M---------EE---?Eo-X-M--B--EEX-XME?----o-M-?M----X--X--E-------EEXB------MX
-o-------ME---E--B--o-o-o--EB-E-o----M--X-----E----E--E--EB-----o-o-B---?-o--M---X-?o----E-o---X-Mo---X-------------E------oX-----?MX------Mo---B-o---X------?--oE-?-B-------M--B--B-EXE-M-Bo------B---E
-MMB---X-o-o?M--oo--EoE---M-M-M------Eo---E----o----------B----E-MBXE-Bo--B------E--E--M--BE-----B-?-X--?o--XE?---X-o-M-o----B-------E?----E??--Bo------?--o-M-Moo-XX--X-?--B-B--B----?---oE------M--o?M
X-----?-o----ME-B---o-M----B---?o-X-EB---E-BEoM---B-E---E---o-----M-------E--E-o-oB---?-------o?---ooBB-B-?B----EM-o---MXoX-E------------o?---M-MBoE-?EoB-X-M-----o--?XB---M--o--oM--o------?-MX-B-M--|B
|---X---E---?---------X-----E--------X-?---E----o-?--------Xo---E?---X-?--------oo-----?E---E--------o--o-o---X--E?---o---------------------?---E---E----EB-----o-?---?--o--EX?X--?X-o---E----------o--o
mo-E---o----o--Bo-?--E----o-B------B-------o-----E-o---E-----o-o------o-------E-oE-E----E-o?B------E--X-?-oo-E--B--oX---?----??-E-o----------EE?X---o------o--X-oB--X---BX--X-E----E?-BE---o?-----o--B-o
XXXXXXXXXXXXXXXXXXXXXXXXXXXXXXXXXXXXXXXXXXXXXXXXXXXXXXXXXXXXXXXXXXXXXXXXXXXXXXXXXXXXXXXXXXXXXXXXXXXXXXXXXXXXXXXXXXXXXXXXXXXXXXXXXXXXXXXXXXXXXXXXXXXXXXXXXXXXXXXXXXXXXXXXXXXXXXXXXXXXXXXXXXXXXXXXXXXXXXXX
