-----------------------------------M------------------------------------------------------------------------------------------------------M------------------------------------------X------------------
--------------------------------------------------------------------------------------------------------------------------------------------------------------------------------------------------------
--------------------------------------------------------------------------------------------------------------------------------------------------------------------------------------------------------
--------------------------------------------------------------------------------------------------------------------------------------------------------------------------------------------------------
-------------------------------------------------------------------------------------------------------------o------------------------------------------------------------------------------------------
-X-----B-X-o---E-?B--?-BooXM--M-B--B--M-------M-E--X---XMo--BB--M----MX-MB--------?-??--o------------X------------XM??-------BX--X-o--X----XBo--------oM-------B-------B-----------X?----------E--------
--?-E--oo-T---oM-o-----oB-M--M--o--o-?-B-X-?B-?BMX----B-----------M-B-----XE-Eo----------XoM-o---?---------EMo--X-oo---o-----X-o--oMo-oMoX---M-----X---o----Mo------B----X--X----o---------?-ooMB-----o-
----M--E--|--o-----M-------------------B--o-------o--?o------?-Bo--?-?o----B-X--X--------oB-----o---B----ooBXB-MM-oB-BX-----BM--B-X--oB--M---o-------M-X-----?----Mo-E?------Mo-BBXE-?-?--------------Bv
--M-M?-M-----M--o----X--B----------o-B--o--X?---------B--??---Mo----o-M---------B-o---o--B----X---EMo?--?-------o-oo--B--?-----------X------?----X?B-o---------MX---E?o-?--X-o---oBX----B------oX------f
-----oX-o-X-M-E--XE--X---------M---XX-B-B--X------B----Mo-o-o---X-------o----?-?---M-M----?-o----BBo-o-X--------XB-X---oB----------M?--------B-?B--oo------?-------BMo-----M------oB---X----o--B--o----f
-----o--?-B-----o?B-------BM-------o----oM----------XBM-?----?---MB-XMMM--------------------------------M------M--B--M?B--B-EB-------B------M---o---oB-------X--------M-------M-??---X-ME---X--o-------f
---M------o-----M?-----?--o--M---?B--------oX---------o-oo-----o--o--------X---E-XM-B-To--ooB--EB------------o-------E-----X?-M----o---B---------------M----o-X----?-Mo------------M----M?-T----E-----of
----o---------------?---X----o-M--------M----E---?----B--?X---MM--?-M------M--?Bo----B|---??---X---B-o--X-o?o-B-o---?B-o-?--M-----?-----M?B----o--X--o?--B-M?------oo--?M---o----XM---X----M-o--X-B---?f
--o-------------o-------o-------X---oo-------?------------X-X-----o-------------------X-------T----------------------o---o---oo-------o--------------------oo-----X-----------X--E-------o-X---o------of
m-----o------------MB---------o----X-X--o-o-------------oo--o-oooo------------oX------o-------|---o---T----------------o----------oX----o----o---o-----o-----------------------oMM-o-o---------XX----o-X
X-X--XXXXX--XX-XXXXXX-XXXXX-XXXXXXX-X-XXXXXX--X-XX-XXXXX-X--XXX-XX-XX-X--XXXX-XXXX--XX-XX-X-XXXXXXX-X-XX--XXX-XXXX-X-XX-X--XX-X--XXXXXXX-X--XX--X--XXXXXXXXX-X-XXXX--X-XXXX-XX--X-XXXXXX--X-XXX-X--X--XX
