--------------------------------------------------------------------------------------------------------------------------------------------------------------------------------------------------------
------------------------------------------------X-------------------------------------------------------------------------------------------------------------------------------------------------------
-------------------------------------------------------------------------------------X---------------------o--------------------------------------------------------------------------------------------
------------o-------------------------------------------------------------------------------------------------------------------------------------------------------------------------------------------
----------------------------------------------------------------------------------------------------------------------------------------------------------------------------------------------o---------
-X-----o-----EE---?---o--B---oX----?---Xo-----M-----M-X-?--M-E--X-B--M---X-o-B---o--B----XX---XM--M---X--B--o-M-X----E---------XB--E----X-BX-B--B-E--------BEX-----M---M----B-?-EX-B-XB-X---------E-----
--B--o--X?-?-?BEo-o-----oo----o--M---oo-X----M---M----------??----o-o------o----o-o--M--o?X---o-?---oM--M---?--M-----X?-X?E-X-----?Bo------X----o--oB-E-B--o------M------------XX-o----o-------?BMXM----
---------------?X----X-XX------X--M------M---o----B---o-o----M?--E--o--E-E-------o---o--M----M----E-?-----------?-o------?-----M-Eo--X-------X-----XXMBX--M------X-?M--XBo--E-MXo------MEB-o------o--E-v
-o-M----MX-oM-o--BX-----------o-Eoo---B----M----X--BB-X-M------X??---MX?-BB-B------?----??-------E-X-----E-----------------?----XX--M---o--?------X----M---o-B-----o-----B--X---o?M----??-------M-?-M--f
-----o-----X---X-----------B--?o-----o---E---o---M---o---M-E-----------?X?-----------M-M--XM---M?BM---B--M----?o-o-----X----B-----o-----B-?-----?---?----?-----o-----B----XX----------ooo-----X--E-B---f
---E-o----o-M------EMoo--------X--?---B-XM--------o--o----MB--B-oB----?-o---?o---------------------------B------MXB------o-----X--ooo---------M---B-------BM---B---o-o---oB--o?--?-M----B-B----XBX-----f
---XMo-----M-------o--B----X---o-?------------o----------?-B-----o-----------XBo----------X-------o-M-X------E---oo-------X------B-?X-?XB?----o--------BX--oXo--B--M-o-------M--X----E-----o------BXo--f
--XB---oEE--?-o---B--o---M-----------B---------B-----M-------------o----?---B?oMM-E-----E-BX-o-------o-------XX--X--?----M-MM-------X-----?M---------o---------Xo-E--------M---X--o--X-X-----?--o-----?f
---------M----------------X-----o--o-------oE--------o---o-Xo------X--------------o----?B-o--X--o-----------o-----------M-----X--------X-------o-o----------------?-o-oo---o-----------------o---------f
m---o-X------------o-------o---------------?X?-X--o-----------------o-------o-X---XX---o---o-----------------------o-------Xo----------o-----oX-X-o-o?---------------o---o--------o------X------oo-----X
XXXXX--XX--XX--XX-XX-XX-XXXXXXXX--XXXXX-XX--XX-XXXXXX--XX-X-XXXX--X-XXXXX-XXXXXXXX-XXXX-XXX-XXXX-X-X-XXX--XXXXX--XXXXXXX-XX--XXX-X--XXXX--XXXXXXX--X-X-XXXXXXXXXXX-XXX-XXXXXX-X-X-X-X-XXXXX--XXXX-X-MX-X
