?------------------------------------------------------------------------------------------------------------------------------------------------------------------------------------------------------T
X------------------------------------------------------------------------------------------------------------------------------------------------------------------------------------------------------E
X-------------------------------------------------------------------------------------------------------------------------------------------------------------------------------------------------------
X------------------------------------------------------------------------------------------------------------------------------------------------------------------------------------------------------B
o------------------------------------------------------------------------------------------------------------------------------------------------------------------------------------------------------E
T|-oMBo??-MB-XXB-?M----oo-Mo-E-o?MBo-o--MM?oo-ooXX-oBooXo?o--BXMo--oEX-X-BXEo-?-Boo-X?M?XX----E?B?--XooBBEMXMooo?B-BMX-o--ooXoo-oo-Boo-MMooMX?o?-MB--ooXM?o-M?-M--oX-XXXM?-BBM--XM?M-B-??oXX-oBM-MB-X--M
oX-o--B--M--X-?-B---o?oM-M-XoM?-----o-X?---X-?XMo??M-oB---X-o-M-MoX?M?E-EX?MB----?ToM----oEMoXB---oX?Mo--X---BMo--B---XX|o-o-?BoMX--o----M--M------?-BM---X-----BX--?-oo------ooo---------B-oE--o----EBB
--Mo----?--X?B--X?MXB-B-?--X---M-X-oM----|-oX-B-?---oB-o-o-Bo-------M??BB-XT--o?--|M-?XB?MM----|--BM---BX-?-?--B------MMXB-M-----BX?BB-------B---X------MBX--BME-o-M-?--o-o--XB-----X-BBME-oXMXoMoX?TX-v
MB-X---??M----o-BMM----B-MMB----M--B---XXXXB-B----X?o-BB?B--XoXoX------M---X-B--MMX-X-o-M--XMMMX-?----E-XB-?--B-BBM?o---?---Bo-o--o---E?--XM-----oo-?X-M---XX-XX??--B---B-o----M??XBM?---?XXoXoB-o--|--?
----oMB---|--oX-----Bo-------ooX-----oo-M-M-M---o-M-MX----M-----oMooXBE--ME---o----oo-----o--------BMMXBM-M------BBXBB-o--Mo-B-X--oXXMX---E-?oB?M-?o--o---o-M-----o?--M---B-X-o---E---MX--M--oB-M?-oX--o
-M-B------X--MB--M-X-MEB--B-oMXB----?-BB-o---??BM--?-o------M?--X-?MoBB-o-Xo--?B--M--XoX--XM---Eo---o?XB-B-B-B--oX-B--X?--------M--B--oo-oB--M-----E--B-oMXM-oEB--X--?-oBo-B--??MMX-BX-B-----M----oM-B-T
X---B-M-?BE----X---BB??--X-B?-X--Xoo-o---?-MEB-?-BX--Bo---B---o-Xo---Mo----MM----M-?--M-?EX-oBX??-?-?-X-----X-o-M---X-T-M-MXB?o---o--X?-M--BX---Xo-XXo----?-??M--B-?--o-XM-------BXX--?--oX-?-o--M--o-B-
?-?----B--XE-o-o-MB---?-E?BXBXX?--o--o-B--B-M-------o-?BM---?-E--?----X-ooX----M-BX----X-M-??------B--M?-oo--o-M--?Bo-X--B----oB-??M---o--B-M|-X--|-oB-oX--B-B-?--o-?X?-X-?o--?---?TM----MBB-X----M--o-o
|--??-o--?BMX?X-o--B-??BX--o--o---oo--B-Bo--X---oX-o---------BXBB--oo-?-XX-B------X----B-E------o---?BX-?o-B--o-oo--X---X-Xo--B---------B--X-X----XB--oB-BB-B-?-oBBo----o----X-B---|---o------oEBo-oEX-o
X?M--oo-?-oX?-B?ooB-X---Bo-B?X--X-Xo-o----?B?-?-XBoX-o-B-|BXX-o---XB-o--oB---?o?-B??-o--BBo-------?X--Bo--------?---oo-o-B-??o-BT---??XM-o-ooXo-B?-----------B-X---o--X?o??X-MM--X-XX?B-B?o-o-MX-B-BMo?M
XXXX-XXX-XXX-X--XX-XX-X--XX--XXXXXXXXXXX-X---X-XX-XXXXX-XX-XXXXXX-X-XXXXX-XXX-X-X---XXXXXXXXXXXXXX-X---XXXXXXXXX-XX-XXXXX-X--XX-XXXX-XXXXXXXXXXX--XXXXXXXXXXX-XXX-XXXXX-X--XX-XXXXXXX--X--XXXXXXX-X-XX-X
