T-------------------------------------------------------------------------------------------------------------------------------------------------------------------------------------------------------
X------------------------------------------------------------------------------------------------------------------------------------------------------------------------------------------------------?
M------------------------------------------------------------------------------------------------------------------------------------------------------------------------------------------------------?
X------------------------------------------------------------------------------------------------------------------------------------------------------------------------------------------------------|
|------------------------------------------------------------------------------------------------------------------------------------------------------------------------------------------------------B
XBoE?-?-oM-BB--M?M-BMXB-B---?Mo---o?o?MB?--oBMX-oXo-MoB?o?XB-B----o-M-X?-o-B?B-?T-XBB-BMEooX-M-XXoM?-?ooXMoBB-o?M-XB-o-M-?-MBoB?Bo-XB---o-?o?E-MEM-BoMoBo?BXoo-X-M--BXo-Xo?B???-X----?o-?-B?B-M?Mo--MM-T
---X-?--B----o----?----B--M?--?X--B-M----o-X--o---EM-o--M-M-o-B--Boo-----ME-----|o---BMXXXXB--oM?---T--------M---oo-o-?---o--X---X?o--o?E--??MM-M---?-o-?---M??-M----XB--X-----BBB--M-?B-o-------?-M--?T
M--B---X--Xo-EM-Xo---o?------o-oo--X-o---X-EB-B?o?M--M---o-oB-----MBoMMB-MX-BB--XMXM?-oMBE--?BB-----|?o?o-o-?-XoM-?M?---o-BB--o-----oBoM?-----XB-----B-----o---o--MB---EXXo-Eo----M?----X?M--oo---M-M--v
M------M--oMMX-??M-o?BX-BoXB--o-MMXMXB-BoMX?------E---BB-?B----Moo--o---BBoX--?-o-X--??-??-o-----o--X-o---BB--BX-oMo-?-Boo--oX?-XB-oo-M-M-X-oMo-M-oBX-?B-BXM?--Xo----o-BMo-X??--oX--Bo-----?-MoX-?-M-Xo|
MX??Mo--o-B--o--BB?M--E--oo-M-BX---?--M-MM-o-Bo-B?X-?---B---o-o-?M--o--X--X-EB----XE-----Mo?-??B-TB----o-E---o---?-X-----o-BMo-Bo------o-?--------o-oM----B----o---M-XBM-?-o---MM----M---Xo-o-oX-----oE|
B??o?--E?M---Bo-----M?MX-??--o-MM-o-M--B---o--Bo--?--B-X-?--B-M---o-X?-M---MX--X--MXoB-B--o-X---XX----XoX?X--XoBo-XMMMBoEB?--B-----??-BXB--B--M?X--oM---Mo--E-MM----B-----oXBM----EBo----MB-oEoM--oXMM?B
M--M-M-B----o-Mo?o-BMMXX-----M---BXX------?EM--MB---T--BX----o-Bo-MXB-o-M-M-o--?Mo----B----X?B-------B-XX?----E--?o----?B--o--?o-oo----o--------X?B---XM-M--?M----?---??o-M------X?-?-MB?--oBMo--X?B?-oX
Xo----?B?--M-M-M-oM---B?BXBo--o?-?M-B-?o--?B-----?BX|MX--Bo-BB--MB-B--M--?--Xoo----oo-----oB---M--------B-BB-?BXX-B--XX-X--X-M-BMBXM-?-?X-To-o--o--M--o---oBB-MXE----o--X--B-----?M--M----M--BXXXX---o?T
TB--------X-X---X--o-------BB-?--oE--B-oo-o-X---o--?X-X-B-oX--oB--o-?---B--X-Xo---oBBX--E-B---X-oX-oXo-?------B-?--?-X?X--B?o-------?-----|?-?X?X----o--X-X-----B----?-Bo----Xo-o--?--BoX--oB-XX?M?M-T-M
m-oBo-??X-XXoo?Xo?-ooX--B-o--o--BBMMo--X-XXB-o-oBoB-X-o----B-oo-oo---o-?------?--XB---MBMX-X|--oo?-oXo---|o?|?B--X?-BB--X-B-B--o--o--?o?oBX---B-?Bo--X--oo-o--o-o-X-B-o-B-B?o?--X??-BB-oXMXX-XoXooToo??M
X-X-XXX-XXXXXX-XX-XXXXXX-XXXXXXXX-X-XXXXXXX-XXXX-X--XXXXX-X-XXXXXXXXXXX--XXXXX-XXX-X-XXXXXXXXXXXX-XXXXX-XXX-X-XXXX-X---XXX-X-XXXXXX-X-X-X-XXXX----X-XXXXXXXX-XXXXXXX--XX-X--X-XXX--X--XXXXXXXXXXXXXXXXXX
