?------------------------------------------------------------------------------------------------------------------------------------------------------------------------------------------------------T
X------------------------------------------------------------------------------------------------------------------------------------------------------------------------------------------------------E
X-------------------------------------------------------------------------------------------------------------------------------------------------------------------------------------------------------
X------------------------------------------------------------------------------------------------------------------------------------------------------------------------------------------------------B
o------------------------------------------------------------------------------------------------------------------------------------------------------------------------------------------------------E
T|-oMBo??-MB-XXB-?ME---oo-Mo-E-o?MBo-oo-MM?oo--oXX-oB-oXo?o-oBXMo-ooEX-X-BX-o-?-Boo-X?M?XX----E?B?EoXooBBEMXMooo?B-BMX-o---oXoo--o-Bo-EMMooMX?o?-MB--ooXM?o-M?-M--oX-XXXM?oBBM--XM?M-B-??oXX-oBM-MB-XE-M
oX-o--B--M--X-?-BMX?M?oM-M-X-??-----oEX?---X-?XMo??M-oB---X-o-M-MoBMXoE-E-o-M----?ToM---Eo-MoMX---MX?Mo--B---BMo--B---XX|o-o-?BoMX--oXB--M--M------?-BM---X-----BX--?-oo--------o---------B-o---o--o-?BB
--Mo-E----oX?B---o-MB-B-?--X---M-X-oBB--o|-oX-B-?---oB-o-o-Bo-------XMBBX-X---o?--|M-??B?M--o--|--BM----X-?-?--B-?BBX-MMXB-M-----BX?BB-------B---X------MBX--BM--o-M-?--o-o--XB-----X-BBME-oXoXoMoX?T--v
MB-?MBX??M----o-BMM----B-MMB----M--B---XXXXB-B----X?o-BB?B--XoX-X------M---X-BE-MMX-X-o-M--XMMMX-?--o-EoXB-?--B-XBMXo---?---Bo-o--o---E?--XM-----oo-?X-M---XX---??--B---B-o----M??XBM?--MXXXoX-B-o--|--?
----oMB---|--oX-----Bo-------ooX-----o--M-M-M---o-M-MX----M-----oMooXBE--ME--MB----oo-----T--------B--B-M-M--------XBB-o--Mo-B-X--oX--B-----?oB?M-?o--o---o-M-----o?--M---B-X-o---E---MX--M--oB-M?-oX--o
-M-B------X--MB--MEX-M-B--B--MXB----?-BB-o----X-X--?-o----BXM?--X-?Mo?B--?Mo--?B--M--XoX--XM---Eo---o?XB-B-B-B--oX-B--X?--------M--B--oo-o---M-----E--B-oMXM-o-B--X--?-o-o-B--??MMB-BX-B-----M-----M-B-T
X---B-M-?BE----XXXXBB----X-B?-X--Xoo-o---?-MEB-?-BX--B----B---o-Xo--EMo----MM----M-?--M-?EX-oBX??-?-?-X-----X-o-M---X---M-MXB?o---o--X?-ME-BX---XoB?Xo----?-M----Bo?--o-XM-------BXX--?--oX-?----M--o-B-
?-?----BMXMM-o?MB?B---o--?B--o-?-----o-B--BMB-------o-?BM---?----?-??-X-ooX---oM?BX-E--X?BX??------B-----oo--o-M--?B--X--B----oB-??M---???B-M|-X--|-oB-oX--B-B-?--o-M-?-X-?oo-?---?TM----MBB-Xo---M--o-o
|--??-o--B---?X-o--B-?-?---o--o---oo-oB-Bo--X---oXoo---------BoBB-|??-?-XX-B-----oX-?--B--------o---?BX-?o-B----oo--X---X-Xo--B---------B--X-X--o-XBE-oB-BB-B-?-oBBM----o----X-B---|---o------oEBo-o-X-o
m----o--?-oX?-B?o-B-X---Bo-B?X--X-Xo-o----?B?-?-XB-X-ooB-|BXX-o---XB-o--oB--o?o?-B??-o---oo-------?X--Bo--------?---oo-o-B-??--BTo--?-?T-o-ooXo-B?--M--------B-X---o--X?o??X-B---X-XX?BoB?o-o--X-B-B-o?M
XXXX-XXX-XXX-X--XX-XX-X--XX--XXXXXXXXXXX-X---X-XX-XXXXX-XX-XXXXXX-X-XXXXX-XXX-X-X---XXXXXXXXXXXXXX-X---XXXXXXXXX-XX-XXXXX-X--XX-XXXX-XXXXXXXXXXX--XXXXXXXXXXX-XXX-XXXXX-X--XX-XXXXXXX--X--XXXXXXX-X-XX-X
