?------------------------------------------------------------------------------------------------------------------------------------------------------------------------------------------------------X
o------------------------------------------------------------------------------------------------------------------------------------------------------------------------------------------------------M
|------------------------------------------------------------------------------------------------------------------------------------------------------------------------------------------------------|
M------------------------------------------------------------------------------------------------------------------------------------------------------------------------------------------------------|
B------------------------------------------------------------------------------------------------------------------------------------------------------------------------------------------------------?
M----?-?--?o?BB--M?oo---------BoX-X-BXooo--M?MBoXoTo--B--oBXMBM??o-o-MM--M-Boo?XXM-MB--B-Mo-oBo?oMo--MM-oM?--M-XoXX?-oo--o-M?-o-?ooM--B-X-B?BX-XoooXXB-oX-o--BooX-MXXoMB-oMoX-B--MoTo-MooBB--X-?--ooBB-X
|M-Xo-o-X--X-------??XMo--oXX?-Mo----BMB?X-----Moo|B----XX-X-----o-XX--oX---Xo-?B----X?-M-MXB-?-X-o-?--o---M--B-o---MX-XMX-----?--B--B-Xo?----oXX---o-?---o---?Mo--M----M?--X?-oM-M|---??--oMM--X--M--BM
M-oBB-o-?M-B-X-o?Xo--o-ooXo-X-o--o-------?Mo-Xo-BMX-MBMBBXoooo--Bo?-?o-----M-BX--oM--?-M---o----o-----BMoMX----BBoB?-ooB--BBBM--XM-XX-oX--?--?-M----oo--B-Mo?---?---o-o?----X----X-X-MM--o-o--?BBEB--X-v
o??--X-B--B--oo---o--?-XXXoMM?-Boo--ooXoB--XM-o---oo-----o-oBXB?-M-o-??M--?-B------oB-B--?oM-?-MB-X-Bo--B-B--Bo--X---XX---------X-B-o-XoMo--B---ooX-Bo?M-----o---o-?-MX---Bo?-o--?-?o---oM-M-----?--o--E
?---?---oM--oo-B-Xoo?-M?MMM---?-B?-XoMBo---X-o?-oBMX-----M??-M----oM-----?-X-B-B--X?-o-oB-----o--ooo-------?B--M--XBXMB-X--BoX?-X---o----o----o--M-o----M-BM-?-X-??-o-o------o----M-oX----X-o---MoMoMB-T
M--B--oo---B?M?--Moo-----------M--Bo---M--oo---XX----Mo---------?-?---o-?-?B----oo--??Xo-M-o--XEo-Bo-----XB---------B---X?--M----?X-M-o-o-BoM?XBX-o-X-MB-------B---?B-??----oo-o----?--oM?-B---?-B----o|
-?--oBoXooB-------o?-BoB---M--M--o-XB-o-o-oE-X?M--B---M-oo---BX--B-o??X------B--B??---?---MXBM-MM?--XoM-Xo-o--?BMoM--X--X-X--XMoo-o--MXoBo-?--B-o-MXXM--BBoo--X-o-B------??oMMMBB-BM-oB---?-o?----?M-o-E
o--BB---B?--BMo---X-X-?-Xo---B--o?-o-?o--BX?BX------X--BBoo-?---?-----?----M?--?-----?-o---B--oM---oX?-----------M-M---?MBX-----M??B--oX-B-------?--------?BM--------oBoo--M-----o---M---M----BXo----?-X
ooo--?B---BB--?o--o-oX---X----X-?---X-B---oXX--BXoXBX-B--BBB--o----o-----B---oB--XX---oB?-T---B----Bo-oBo----B--X---B--------B?B------BXo---B--oB-Boo?X---------o---To-BoXo------o--?-??E---X--E---T----
mo?-o---XB--o--oooB-o-Xoo??-o--B-oXXBB--o-X-?-o-BX--B?-------?--X-??-------?-X-B-XXo--o--B|X-|-X?oo-XBB-?o--o-ooB----?o--oXXo---X---X--Bo--X--oX-o-??-XXB-o-oo-B----|X---BXBo-B-?Xoo-XB?X?-oo-?B--o|---E
XX-XXXXXX--XXX-XXX-XXXXXX--XX-X--XXX--XXXXXX-XXX-XXX--XXXXXXX-XXXX-XXXXXXXX-XX--XXXXXXXXX-XX-X-X-XXXX--X-XXXXXXX-XXXX-XXXXXXXXX-X-XXXXX-XXXX-XXX-XX--XXX-XXXXXX-XXXXXXXXX-X-XX---XXX-XXXX-XXXXXXXXXXXXXX
