?------------------------------------------------------------------------------------------------------------------------------------------------------------------------------------------------------o
-------------------------------------------------------------------------------------------------------------------------------------------------------------------------------------------------------|
o-------------------------------------------------------------------------------------------------------------------------------------------------------------------------------------------------------
-------------------------------------------------------------------------------------------------------------------------------------------------------------------------------------------------------|
T------------------------------------------------------------------------------------------------------------------------------------------------------------------------------------------------------E
M-oMB----oo--oMEB-----B-?oo?M-MoMXoo--B-?---?-B?----M???X?-o---oMMXBoooMXXB-?o--o-oB-Mo----B?o-oBo?X-oo-oo--M--BX--Bo-X--o-BX-ooo?-o-M----M?oo-M-??MX--o-Boo?o--oXM-oBX--?-?-XoM-o--?-ooMMBB-oo-o?o-o-MT
oo-----BMMX?XXX?oXM-oB-o-B?--X---X-XB--o-B-B-M--oo?B---o?--B--B?-o--XBo-B--BoB??-BB-?oM-?MBo---M-B-?oB?ooX-o--?--------BXM?--oMMo-XMoo-?-o---M?-M---o--BM-BX-MooBM--Moo-X-oo--X-MMB?-XM?-----BoMM--oBX-E
XM-oo-?--o--XBo--o-M---??oo--M-oo?--o--MB-B-X-o-o--o-?oX-M---Xo----oo-?o----oo--o----B-oooo---oo--B-B-o-oMXM---Mo-?-M?-o-oo-o---M---B-M-o--M---M-oM-?M---o-X--Xo------?--M--X-o---o-X---B--------?oB-?ov
T-------Xo--Bo--o-o-oX---?BM---B----o----ooM?oo-MM-MM-MX---o-o---?ooM--M--?---B-Mo-oB-oo?oXM-X??---o--B-?-X---M-X--Bo-o-o----B-B-??----?XX---X---o-o--oo-oo-ooMoM?oooB-?X-MoXoB-X-o?--Mo--oB-?o-----BoM?
T-MBM-o------MXoBooMB-??--o-B----??-MB-------M?o---oB--XB?X?-?X?--BXoXX-----o?-XoMMM---o-M?-Bo--?oo-o---oM---?o-oBM-X-BoM-oM-----o-MX?M-oM--MoX--B?-MB??ooo?o-oo--?MB---oo-oM--B-oo-o-oo--?--o----M----o
oo---B-X-o----oM--------ooo-o-oMM--Xo-o?X--BM----o---oo?-oooo---?M--ooX-oo-------o--MMo?o--o-?o---Bo-M-B----ooo-B--oo--MoBMo-----o--B--?--X--M?oM-------BBB-?-oo-?---B--BM-ooBo--X---?M?-o-Mo--?B--X?--M
oM-MXoo-o?-o?oB--XoM-o--?-Mo--B-oo-B--o-o----M-?oB-o?B?-oM?-?MoM---MMoo-MBX-B?-------oBo?BoBM--o?-oMo-?-??ooB--X-X-BB-o---o--Mo--MoB-o--o-X---oMo----XoB-----Boo-------Bo---?-ooX--oo-o--oo-M-o-o-oB-??X
M----B?------X-B-XMoM----ooBo--B-M---ooo-o?--oo-o--------o----Moo----MBM---?--oo--M--Mo-------?X--X-Bo-M----MXo---X---o-MB?--oX---M--o?-X--X--o-?oM-M-o-B--M---MXM--B----Xo-o-X-MM--?o-X-Xo----E--X----T
----o-o--E-o--o-oo-------o------X----X-X---o-o-------o-----XoX--oo------o------To-o------o--XX-------X-o------o-X---XXo--o--T-------X-o-o----o------o-X-o-----o-----o----------X-o-----oX---o-X----o-o-E
m---oX--BM-X-----oooooo--Xo-|-X--ooooo-o-o---X----o-oo------oo--X--------oo-oo-|o--o--oo-oooo-oo---oXX--ooX-ooX---o-o-oo-o-X|--o--oo----o-----o---o-o-o--X-o-----X|--o---o--oooX-ooo--ooX-ooo---oo--Xo-?
XXXXXXXXXXXXXXXXXXXXXXXXXXXXXXXXXXXXXXXXXXXXXXXXXXXXXXXXXXXXXXXXXXXXXXXXXXXXXXXXXXXXXXXXXXXXXXXXXXXXXXXXXXXXXXXXXXXXXXXXXXXXXXXXXXXXXXXXXXXXXXXXXXXXXXXXXXXXXXXXXXXXXXXXXXXXXXXXXXXXXXXXXXXXXXXXXXXXXXXX
