o-------------------------------------------------------------------------------------------------------------------------------------------------------------------------------------------------------
?------------------------------------------------------------------------------------------------------------------------------------------------------------------------------------------------------|
|------------------------------------------------------------------------------------------------------------------------------------------------------------------------------------------------------T
?------------------------------------------------------------------------------------------------------------------------------------------------------------------------------------------------------|
X------------------------------------------------------------------------------------------------------------------------------------------------------------------------------------------------------o
E-o?-?B--Bo?-X--X?--E-?BBoBEME-M-------?-B?--?o--BoMo?B-o?B-o-BB?MEBMX--ooMEBo?-o--M-M--MBoX?oBMMoMoM-B--?o-XMo-o-?-EoB-MM-X-?BMM?Mo?--Xo-MX-MBB-X-M?oX?M-BB?-?-X--o-oMX-o---oBBo--MXB-oM-o-oBo-----oBB?
??--o---o------o---BM------M-M?-EoBo?---oo-o----X-?-?ooX---?o---o-M-oBo-Xo-M---MBB-o?--o-ooX-?oooM-Xoo-BooB??-o-ME--BE------o--o--oB-X?BB--o----B-o--MM---o--o-o--oX-M-MoB?-oM-oXo--X-o-o-X?E-B-MM-?---T
?--MXoo-MB---Moo--EoXB?-oXMM-B--MX-?-M--M--?---?oXoB--Bo--o----o-MM-ooM?oB-o-o----?B-TBo---?--B---o-oM--?----EM--XMo|XM--M--X?-?--XM?----?oBB--o-Mo-o---T--o?---X-Xo----M---M--?X--o-X?o--X?MB----X-BX?v
XM?-Mo-?----?-Xo--MXB-oooM--Mo---BBoo-Bo-oo-o----X--?--B-?--oo-Mo---?---ooX?BMM-o---X|-?-?B-oM-B--Xo-ooo--X-M?-oo--oX--MM-XM------oo-----o?---oo---MMBBB|MMM-o--B-M?-o-?oX-o--M-?-MXoM--X--oBX?M--M----T
B----?Mo-o---oBMoXB--M--X-------o-o-BX--?M-oX-X?-MoB-?--oo-XMBBoB-oMo----o?----oTEo-oX?o?--oo---o??MooMXXE-----X-o?---?--M-oB-X--MX-?o-BX?oo--?MXE?-----X---B--X-X----B--?B?M?---o-M--o-o?-B--?-XB-ooo?-
?-BBM--oM?BoBMoo-oMo-o--E-------XMo--o-o---?-oo-B-M-BMXX-o?o---B-----o--o----o-MBMB-MB------X-o-B-oo?M--o?B--?-?-Boo---?o-M---BMX-M?-BXoo-XoBo--??o--M----B|o-oX--oM--oE---?-oXo-?o-B?MMooB-X-BMB--o-M-|
|B--o-oM-oo-o-oXoBoBB?X??BoX-?----XM-o-o?Bo-BEM----BB?--o?--------?MoM---XB?-B-?XX-M---X--ooEM-Boo-o-o-?X---oo--ooEB|-o-X---oo------?-o--X?o-Bo--EX---X-XEoXXBo-X-?o?BMXE|--oB??-o?----oB--EB-XEo-M?oooM
---X--M--B-M--?o--M---BB-o?-X---o-?-oB-X--o--X--B??-----?---?----B--M--oX---?--o-MM-X--?-??BB------XB-----oX-o??-o?-X-?-XM--X?B?BBX---X----X---BoMBooX--???M--B-------XX?--?o---o--o--o--EoX-oMXooooMX??
o--EoE----X-o---E---------oooXo---BXo------ooo-oooo-X--------------ooo---X-ooooo-o-oo-o-X--XX-oo---oo---oXTXoo---X---o-X--Eo-oo----o----o----E------M--ooo--XXo-ooXX---o-XooX--o--EX--oMXBMX-E---XX--o-E
m-BX?BB--o--oo--M---|oo|oXoXoX--Xo--o-o---o-o-oo-o----o-----Xo---oXoX--o---XX-----oX---o--ooXXooo-X--o-X-X|XX----oXoo--XooXo-?--ooo--ooo--X-X?----oXoX---o-Xo-X-o--o-oooooX|-o-o-XXo-|-o?-o?BX?-----o--|
XXXXXXXXXXXXXXXXXXXXXXXXXXXXXXXXXXXXXXXXXXXXXXXXXXXXXXXXXXXXXXXXXXXXXXXXXXXXXXXXXXXXXXXXXXXXXXXXXXXXXXXXXXXXXXXXXXXXXXXXXXXXXXXXXXXXXXXXXXXXXXXXXXXXXXXXXXXXXXXXXXXXXXXXXXXXXXXXXXXXXXXXXXXXXXXXXXXXXXXX
