|------------------------------------------------------------------------------------------------------------------------------------------------------------------------------------------------------o
X------------------------------------------------------------------------------------------------------------------------------------------------------------------------------------------------------X
?------------------------------------------------------------------------------------------------------------------------------------------------------------------------------------------------------B
E------------------------------------------------------------------------------------------------------------------------------------------------------------------------------------------------------M
B------------------------------------------------------------------------------------------------------------------------------------------------------------------------------------------------------T
X-B-B--B-Mo-o?-MMBM--M-oXoB-Xo-ooo-BoB-?---B-?o-M?--M?B?---|-oo?B-B-M?BEooX-??M?ooooBoo-?EoM-?-?BBo-?MooXoBM-o-?o-XXX-o--?--ooMM??oo-?oX--XMXBooo--?B---Boo-XoooB-X-oMo?B?-?o|-MoXoM-BM?MoB?-???B---oB-E
TB-o-?M---??M-------o--X-o--XM-X--o-M---o-X-X-?---------o-?XooX----M-B?BX-XB------Bo---MBXB---M---Xo---oBB--ooX-M?-M---MB-MoXB----M----o--X-B-?--??----o-Xo-X-M----M--B---M-MXB-BM--o----o--o------|?-o-
---X----oM--------X?M?oB-MBMM---XBX---XBoo--oX-B--ooXXo-X|-o??---E--oB??-o--B-?----E-o---E-BM-----o?M?B--M?-------X-o-o--M-MM-BB---o???-X-?o---?X----B-Moo-oB---B-o----MX----?-o--M-XB--M?--oo-o--XX-o-v
|--oB--oo-MMX-X-XXX---o-------B?--oM---o-X?BBX?-oXMMM-B-BX-X--MoB?--B---?M-M-?--?-?B-Xo?X?B---o-oo-------?M--ooMB--o----B-X-------------?--?-?--?-o-X-o-?o-B-o-o--B-oM---?BB---M-X-XB----MMXX--X-?XX?M-|
E?oB--o-MB--M-?o?----M---MX??X--o----Eoo-?---B-ooB-----o-oooX--M-M?o--?---o-B-------oXMB-ooBXoX-MX-o-M-MX---o?X----o-MBB----Bo--?o-?M-Eo-|o-?-XX---BBE?---B-B---MX-oo--oo-X?--M--X-B-?-BB?-o-o?-X-Eo---M
|-M----M-----B-M--?-?-X-X-----XoB--B?MB-B-??--M-M-XM-Mo---XXM-o-B--XooMBM--X-----MXMo--B--?--Xo---?---M-Xo--o---?-o-o---TEoB-?------XBMX-X-o-oX?oXB--B---X---?X?--o-?XoBX---o--BoB----oB-M?Bo--o--MoB-B?
-?--BB--M-?-M-M-oM------B-MXooMB--?----M----?---------Bo---M-MM--E--?X---o?XXM--?-------o--?-?X?----B--BM??oBB-BooooX-Mo???----o-B?MBM----Mo-B---o-E?-X--oX-?-B-ooBM-XB-o-?XBo-----B--o-B---XMMMXT-----M
M--M------------o-----X-----X---o---X-B-BoX--BM--BMBX--X-MB-o--XXBX?-Bo-oo-XB-oX-XoXoBo-XBB-T-oEMBoB-|-----B-?--M?-B-M-XX-----?X--oo--?B?o-----o?BXM----o-X----XM?--o---M--M-XoBo-M-?oM---MME---oXoMM-ME
|---BX-B-oo-?X-?--?----o--oB-o-----o-----?oX---oB---?Xo----?--?--??-?--o-o-B--?--oBB--X-----|??B--o-oXo---?----E----B-?oB-oM---oB-B----X--BBXB-B-o----Bo-----------?X-Bo----?o--X------o--XBBXE??o?---B|
m--X--?-o??--oo-oo--o-oBB---o--ooX-?o-X?B-BoXXoo--|X--o-??o-B---B----Xo-B?-----ooB--oo-o?X-BX--|??X---B-B?--?-oBo?X?---o-o??-?-X-o--B|-Bo-----o-oXX--o-oXB-BB||XBoo--?-oToB?-o-o?-?-Xo-BooX-?B?----X-?-o
XXXXXX--X--X-XXXXXXXXXX--XX-XXXXXXX-XXX--X-XXXXXXXXXXXXX--XX-XXX-XXXXXXX--XX-XXXX-XXXXXX-XX-X-XX--XXXX-X--XX-XXXX-X-XX-XXX--X-XX-XXX-XX-XXXXXXXXXXXXXXXXX-X--XXX-XX-X-XXXX---XXX-X-XXXX-XXXXX-XXXXXX--XX
