------------------------------------------------------------o-------------------------------------------------------------------------------------------------------------------------------------------
--------------------------------------------------------------------------------------------------------------------------------------------------------------------------------------------------------
--------------------------------------------------------------------------------------------------------------------------------------------------------------------------------------------------------
-------------------------------------------------------------------X-------------------------------------------------------------------------------o----------------------------------------------------
----------------------------------------------------------------------------------------------------------------------------------------X-------------------------------------M-------------------------
----?---M-B-X--------X--?M?B-M--XTB---oX--X-MB---M---Mo--X---?XB--B-X------?X---?MM?-MB-B------B-X-?------B???-----B-?-?-BMM--BX?---MM?---?M-X-M--BX?-X--M-BMMX-M?-?-BX-M---o---X--?-X?-?---M---?---XBX-
----oX?B-X------MM-MXB------Bo--M|--XX--------o-----X-M?BB----X-?--?----M-B--M----o----B---BX-B-BX?-X?---------XXBM---Xo--oo--oX---X-?--X--o??M--M----M-M-B-o----o--X--?-X-MMM-B-B----MM-BM-oB-----B-o--
------o-??-M-?--o--o--?-EB-B-B?--X---M-?-?---BM-B---ooo-oo-----X---o-XXX-X----M----X?-?------B------X--MBXMMX-MBX----M---B--MX--Bo-----BB----o-?---BX?oo-X----?---MM-X---?Mo--M-?oooM-o-M-o-X-B-M?--MX?v
-XBB-oB--------?-?B----MM----o-M-?BBX----M--MX---M--?BM----X?B-oB-?-------BX--o-B---o----M?B-o-M-oM-BM---o-oX----MB----B---Moo----M---o--B------B?-oM-?M?-X-?X-XX--------o-X---------??X-?--M--------B-f
---oB----?--BMX-X---?---X-----------BME------B-----Mo-ooMM--o-----o-X--BM----?---X----M?o--o--?----M---???--M-M-----?-o-?-B-M?-ME-----o---------------------o---??--BX-oB----?--X---?--?-oXM--?--B-X---f
-?X-o-----B---X--------?--M-?-----?-XXMX------B----------o-----B------Bo--MM--XMM?---B-o--B--M--B-------o--?-B-MX-M--M--------M?Mo--?X---MBXXMBM---?M-B-B----M-X-o-X--------M----B?-----?---XX----B--X-f
---X----??-----B---X?X-oBX---B-o---o---X-X-M?----?-MMM-M---o----B----B------M-X-o--------M-----XooB--M-?------Mo?Mo?--?M?--------B----M?----Bo---?-o----o----o?M-----M---X?B----?--MoM---M----B-----B--f
---M--M----?----X--?-X-----X--??-X--B--M----------------?X-XM-?----Xo-M--------?-MX-?--?-o--ooB--E--B-M--M?----B---o--o-o-B-X?B?----M--o?B--------X--B------------BMX----B---XX-------M--------X---M--Xf
-----------oTX-o----------X----------X-o-----o--------XX----o----------X-----o-o-Mo---------X-oo-B-----------------X-------------X------o---X-X-------X-----------o------o---XX------------------------f
m-----------|---X-o--X-------------------------X------X-----X--------X-X----XX---------------o-?--------------------------X-----X-----X--X---X----X-------X-----------------Xo--X-X------X-------------X
X--XX-XXXX-XX-XXXXXo-X-XXXX-XXXX--X-X-XXXXX-XXXXX-XXX--XX-XX-XXXXXX-X-XXXXXXXXXXX-XXX--X--XXXXXXXXXXX-XXXX--XX-XXX-XXXXXXXXXXXX-XXXXXXXXXXXXX--X--X--X-X-X-XXX-X-XX-XXXXXXX-XXXXXXX-XXX-X--XXXXXXXX--X-X
