--------------------------------------------------------------------------------------------------------------------------------------------------------------------------------------------------------
--------------------------------------------------------------------------------------------------------------------------------------------------------------------------------------------------------
--------------------------------------------------------------------------------------------------------------------------------------------------------------------------------------------------------
--------------------------------------------------------------------------------------------------------------------------------------------------------------------------------------------------------
--------------------------------------------------------------------------------------------------------------------------------------------------------------------------------------------------------
--XMBMBT--B?XMBXX-??Mo---?MX-M?---MB-MM---X--X---M-?M---M?-BX------TM-o------?X?-----MMMo---B-------X---?----X----?M?B-X--BM-XXM-Boo?BX-MM-M?ooM----oM-?---MB-XB---X-B-MM--?X---B-oMBBB--B---M----X-----
---ooo-|oXo----X-?o--?-??-o?-o--B---Bo-?-M--M--X--X--MXoo-M--MMo-?-|--?----?-o----X----oX-?---XB??B-MB---B--X-MXX-o---B?B---XX--?-X---B---X--?X-TBM-B---?-X-------XMM-M--B?-B?---?Xo---BB-MXB--MM--B----
-B--?M-X?MMX---BM-?-oo---oM--XM---?--?-------BM--X----M-X--MB--?-o?X-----M?-?-----M-XM--M-oBM----o--------------oB-?-------XoX-M---E--oX-?X--o-o|----X-o--EM-?----X--?-----X---B-o----?-------X-----?XMv
-o??--B-o----B-----B---B--o-E---XX------------------BMo-BX----?--?oM-X-M--oXo------M---?--X--------X--Xo--B--BX-M-------MMXBM?-o?-M?----?--X---?X-----B?--M-Moo--XX-B---B--X?B--?XMX?---?--BB----MX----f
----MX-----B--------X-M---?XX---??-?------B-----??B--o-Xo-M-------o--?--B--B-BM-oM----M--?-?B---?-??Mo-M----M----X--?-o----o---o-B--?--X--BX-----oX-X-X-B--X--?oM-B--BX-o?-Mo-?X---o-M----Eo-----o---?-f
---Bo---Xo--BBoB--?-T--X?M-X--?Xoo--o------X---E-o-----o-----MX--BX---XM--?----MB-XB---X---oo?X------?M-MB-B--XX--X---?--B--------o--X?-oX-B-?EXM?-MoB-----------B---o-X--X--X-X--XM---MB?X-----X--M--Xf
--oo--XMB-----B-oM--|X----BBBB--X-B?X---o--MX-?M----?M-MXM-----XB--?--?o-?---E--o---Bo--?M-?B-o?-?Xo--oo---o-----oo??X-?M----B---X?MX--E?-?o--?oo-X-?----B--------oo---X-MB-------o-?--o-X----?X-------f
-?oX?X-o--?-MM-BXoo-X?-------ooX-----Mo--o---E-M---?-o-----X?X-M---o-B---o-XMXX-B---o?----B-o-X----X-X-BM--X?-?--M?---oo--?-Xo-B-X-----B-M--o-X------X??M-o---?M?--X--B----X----M?---M--E------X----X-Bf
-------o---X----XX--X-------o-----X---X--X---M-o-X--T---E---------T-X-X-----o----o----X-----X-E----o------------------o--E----------------X--X----T------XX----o--o----------------T----Xo--XX----X----f
m---X----------X-X---------o-------oo---X-----X--o--|---M--X-X----|--------------X-X--X----o-?B-----------X----------o--MM-----------X---oo---X---|--X---X--o--oo-X-----o----T-----|---X-o---X---------X
XXXX--XX-XXXXXXX-X-XXXXXXXX-XX-X-XX--XXX-XXXX--XXXXXXXXXXXXXXXXX-XXXXXXXXX--X-XXX-XXXXX--XXXXXXXXXX-XXXX-XX--XX--XX--XXXX-X--XXXX--XXX--XXXX-X-XXXXXX-XXXX-X-X-XXXXXXXXXX-XXXX-XXXXXX-XXXXXXX--XXX-XXX-X
