M------------------------------------------------------------------------------------------------------------------------------------------------------------------------------------------------------o
E------------------------------------------------------------------------------------------------------------------------------------------------------------------------------------------------------E
X------------------------------------------------------------------------------------------------------------------------------------------------------------------------------------------------------o
|-------------------------------------------------------------------------------------------------------------------------------------------------------------------------------------------------------
M------------------------------------------------------------------------------------------------------------------------------------------------------------------------------------------------------?
?--o--oBoo--o---oX-M---o--o-Bo-o??ooBMoo-o---X--?--E--------------?----oooXM-o--------o--o--?---oMoo---o--oo--oB-Xo---?M---oo-o-X--o-o---Booo----------Bo-o-B-o-oMoooo---oo?o-o-----Mo-o-?o---o-o?-o--X|
oo?----o-------o-----------M---o---o-------o-?---o-?oo-----B--oB--o-----X------------o--oB-----ooo-?--o-----oo----o----o--B-o----M-X--o-----o-------B-----oooo-X----ooo-ooo--oB----E-B---------oo----o-E
o--o-oo---o----B-----o----B---oo-------Xo----o--oo-o----o----------M--------o-Bo-?---B--ooo-oo------------o-Moo---M--o-----o-o--o----oo--ooo---Moo-o---X-----E---o----o---o?E----MMM-o??X------------o-v
X-o-----M----o-------o-oXo-----o------X?------o-X--o--oo--o-Eo---oo-----oo-B-oo--o-----o-E--o--o-----o--Eo---o-o-------?-o-------o---E--o--M-o-oo-o-o-----o-o?M---o---ooo-o-?-----o--X--o?--B?o-oo-o-o-X
----?----o-o--o----Xo---ooo-o----B--------X---?-o?--o-EoooM?XXo-Mo--X----------E--X----MXMX----o----?o--B-o---o--oo---o-----X-o-o----?-o-----oooB-------oo-ooo--o------M---o---o-o-------------o----o---
X--o----------o---o-?---?--------------Mo--o---o-ooMMBM-M---o-----oM----XX-oo---?--o?----X--o----B---?-----oo--o-o--o-------o-------o-oo--o----X-o-----o---M--o-------o---o--o---M----o-----o-o-----Bo-M
M?-o--o-o---M------X--o--------oo--o-o----o--o---o---o---------o--o-B--o-----o---o-o------o-----o-?o----------o---ME-M---oXoB---------o---B---o----o--o?-o---oXo-X-M-MM-?--B---o--o--o-----o---o-M---o-?
X--ooB---o---oBooo-o---------oo---o-----o-o-o--o--o----------B?-o-----------------M-o-o-----oB---ooo-----------?--XX-----o-----------------o--------------o-----------------------oX----oo--o----------X
--------o-X---oo---o--o--o-----o----X---------o-------oo---o--ooo---o--o--o-oo-----o-----------Xo--o----o-o-E---oo-o--------------------o------oo-----------oo--oo-o----------o----------------o-------M
m---o---oo-oo----oo-ooXXo--o--Xo-oo-o-----oo-o--o---oo-o--o-ooo------o------oo-o----o-oo--o-oo------o-----M-B----------------o-----o-oo----o-oX----o--oo-o----o-Xoo-o----ooooo----o-o-------oo-oo------X
XXXXXXXXXXXXXXXXXXXXXXXXXXXXXXXXXXXXXXXXXXXXXXXXXXXXXXXXXXXXXXXXXXXXXXXXXXXXXXXXXXXXXXXXXXXXXXXXXXXXXXXXXXXXXXXXXXXXXXXXXXXXXXXXXXXXXXXXXXXXXXXXXXXXXXXXXXXXXXXXXXXXXXXXXXXXXXXXXXXXXXXXXXXXXXXXXXXXXXXX
