------------------------o--------o--------------------------------------------------------------------------------------------o-----------------o----------o--o------------------------o----------------
----------------------------------o--------------o-----------------------------------------------------o-------------------------------o----------------------------------------o-----------------------
-------oo------------------------------------------------------------------------------------------------------------------------oo-----------------------o---------o-----------------------------------
-----o--------------------------------o--o------------------------------------------------------------------------------------------------------------o-------------------------------------------------
------------------------------------------------------------------------------------------------------------------------------------------------------------------------------o-------------------------
--o-B-ooM-E--X-X?---o-M--oB-M----B?---?-B-o-o-E----------M-----MoB--E--X--X-o----X-M-BoM----oB---B--B--M------o------E--BB----Bo-?M--??--ooM-MX-B------o-MX----M-------X?-?----o-XB---ME--?--o--M-M-----
-?---X--X?X----MM--o-M--EX?----E---X-X--X------MM----o----Mo?--X-E--o--?---E--M--o?---M-o----M--EX-?-oM--XXX?-B-----M---X----M-E-?X---M--X?B--BM--M-o------------M-?--M----o--E-X------o--M-X--MBE------
---?-oBEo-----o-o-EE-----B----M?Mo---X-----------o---E---XXoB-M------o-M-?-B--M-----?oEo-----M--E----XM----o--o-----?---?---E--B?E--oM-X--X----o-----X---o---E-----o--?---X-------B-----M-?---E?-----X-v
-E----o---E---E--X----o---o----o------M-?-o--E?---o--Bo--X----M--?oBEoBo-----E-------X---EE--BME---------oE-o-------oB----E--o-------?---E---?-Bo?-------BMX-o---XXE-oEX---E----ME-------o--?-ooX----B-f
-M-BM--oM-BE-X--MoB------M-?---o----------B----?-B----M----X-M-?XoB----o-o------BM---M------?B-------------------XMXoBEB??-o-----X?o-?EX?-EMXE---Boo--E--o?-----o-o--oo?o?--?--o---EM------Xo--oM?---o-f
--oB-?-?Xo---MBX--B-----E-o?BM---M-?-XB---B?B----?-------?--B??E-E-B-oX--Bo--?--Mo--B--oBEo--oo-X--MB--B?XMX--X-X-X--XB?-Bo---BE---M-XoM-----M-X??----E--o--X--X-BM-----------XoX------?--M-?--Mo--X?o-f
--M--B----X-o----B?-o--E------oXXE--?o-ME?--oB-oB?B--o-?--E-?--o-?-?ME-E??B?--?---B-B--MEB-??-o---B--X----o-----?---o----X--B---?-M--o?-?--MB-M-EE-----M?MM??M-o---------B?Eo-M--M-oo---o?----oE---o-?-f
--EX-BB-X-X-M?--?-M-----?--X--ooE--M--o---B-----E------oMMo-----M--B-------o----o----------??---E?-----XMoo?---o-------?--B-----?----E----B-M--EMEB--o-o---o--Eo-?X-oB--E-X-oE-XXo-oo-X------M-?MX--B--f
---BX--B----B---E--X--XX--?E--E-X--?----B-E-o---o?----o-X-o---o---E?-o-E---------o-EE-E-----o----BE---X---o------X-----B??-?--EB-----o?X-?oo--o----o--EB?-------o---o--X--o-XB-----E?-BXEX-----E-?--o?-f
mo-B---o-------?--XB-E---B--o?B--o----------X--?-BX-XE--oX---?-X-?-----?--Xo?X-o-oBB-------EBB--BB?----o----------------E----o--o--X---oo--?--B-B-----?BE--?----?-?--o--E---B-------o--?---E?o---E-----X
XXXXXXXXXXXXXXXXXXXXXXXXXXXXXXXXXXXXXXXXXXXXXXXXXXXXXXXXXXXXXXXXXXXXXXXXXXXXXXXXXXXXXXXXXXXXXXXXXXXXXXXXXXXXXXXXXXXXXXXXXXXXXXXXXXXXXXXXXXXXXXXXXXXXXXXXXXXXXXXXXXXXXXXXXXXXXXXXXXXXXXXXXXXXXXXXXXXXXXXX
