---------------------------o------------------------------o----------------------------------------------X----------------o-------------------o----------------o-----X----------------------------------
-----------------------------------------------------------------------------------X---------------------------------o------M--------------------------------------------------------------o------------
-o---------------------X----------------------------------------M-------------------X-----------------------------------------------------------X---o---------------------------------------------------
------------------------------------------o------M-o--------------------X-----------------------o----------------------------------X-X------------------------------------------------------------------
----X---M-----------------------------------X------o-----X--------------o-------M--------------------------------------X------------------M-------------------X-------------o---------------------------
---oX-o-----?X-?M?M-M??XT-?X?BMM-BM-oXX-?---??oB-oX??--?X--M--XM--?X-M----?-----B?-oXB-BBX-??o---XB?--X-XBXX-B-XM?X--X--MBX--o?X--M?---o--?X-B---X?X--?MMX-BE--M-X?---B-X-----BB-XMoM-B-?X-B---MX----MM-
---o--XX---------o--o---|B-B--o------?--oBB---?---M--MB-----X-?-?------o-B-M-?o---M---B---o--o-XB----B-Boo-BXoBo-o-MBX--B-B----Mo---X-o?-X-M--X?Bo-?o----MBMX?--X-oX-----?MoMX---MoX---?--?-o--o--B?--M-
-----------M-?XXM-M----MX---?--o--?-oo--X--------BM--ooX-X------o-o?---XM-----BM-o-?-X--MX-------MM---X--?--M?-B-Xooo-----o-oMM-B-XX-B---?o-?MM--o--X?BM--MoX-B----B-X--o----X-MXo-M-----X------oB-o?--v
-M--?M-X---oXo-X-----o---Boo-X--Eo-Mo------X?oB-B-?---oEXX-BX?---X-oX---o?--B--o--B-XXX------Moo----BXX?M-X?----?M?MoX---BM-----oB--------M------?BM?----X-oM--ooB---B-?-o?MB---B--o?---B--?-?--?-----Mf
---oXo----B?-XMM?-?oo-BBo-?-?X--?o--MMo---?-----o--X---XBXoo-o?-----E-B--oB---MMX-M-?--?-?-o--o?-XMooM-o-?---M-B------BM-o---?--o-----X--------o-X--X-B?MB---M--M--?--?-o-X--MM------?XMo?--X--B-?EMMXof
--BX---?B-o-MM-----BX-o---o--XMMMM----?--?-?M--M??-----B--XXX----oXMM--BXM--o?-X--X-----X-???--o---X-o----------XX--X--o------B------BMB--o?-MM--XX-oooo-o-------?--X---?--X-X-----B-oBo-o--B--o--B--?-f
-Mo--B-o-oX-----X---o--?M-B----M---M---X?----B---oM--o---oX-X--XX----o---o--?----MoM-ooB--oo--MX--XBXXX-MMB-X?XMX--X-E-X-?XX-----------o-M-----XB---BB?-XBB--BM-Moo-M----X-o-------o--o----B----X?-o---f
------B---MXM----M---M-------B-o---o-XM?-XB--o-XXMo--Mo-?M-BX-o---o?M?M-X-?X---o?-B--MM----X?--MXXMX-o-Mo-oM----M--?XBM-Bo----E---XB--BX--X-X-M--XX-E--?----X-----MB------?oBooMM?---M----------------Bf
----------X-----------M-o----------E-X-----------------X--o---X-oT-XT-X--Mo------X-E-----X-----o-X----o---------------------X-XX-o-o-o-----o--------X---o-o------o---o-------XM-----o-X-------o--o-T---f
m------o-----------M--X--M----X--MBoX--------Xo-------------MX-XX|X----------------X---------X-M-o---------X------X-XX-----X---X-----X-----X----X-X---oo--o--o------o-o-------o-----X---X---o--o-X-|-o-X
X-XXX-XXXXXXXXXXXXXX-XXX-XXXX-XX-XXXXX-oXXXX--X-XX-XX-XXXXM-XXXXXXXoX--X-XXXXXX--XXX----XXXX-XM-XXX-X--X-X-XXXXo--XXX-X--XX-X-XXXXXXXXXXX-X-XXXX--XX--XXX-XX-XXoXXXX-X-oXX-XXXXXX-XXX-XX-XXXXX-XXXoX--XX
