--------------------------------------------------------------------------------------------------------------------------------------------------------------------------------------------------------
----------------------------------------------M---------------------------------------------------------------------M----------------------------------------M------------------------------------------
-----------------------------------------------------------------------------------------------------------------------------------------------------------M--------------------------------------------
----------------------------------------------------o---------------------------------------------------------------------------------------------------------------------o-------X---------------------
--------o-----------------------------------------------------------------------------------------------------------------------------------------------------------------------------------------------
----?---M-B-X--------X--?M?B-M--XTB---BX--X-oBE--MB-o----X---?XB-?B-X------?X---?MM?-MB-B------B---?------B???-------?-?-BMM--BX?---M-?--o-M-X-M--BX?-X--M-BMMX-B?-?-B--M-------X----X?-?--?M---?---XBX-
----oX-BoX------MMBMXB-M-o--B---M|--XX-----?--?--o--X--?BB-X--X-?--?----M-B--BB--------B---BX-B-BX?-X?---?----oXXBM-BoX---o---oXo?-X-?o-BM--??M--M--o----o--o------oX--?-X-M-B-B-B---M-M-BM--B----?B----
--------??-M-?--------?--B-B-X?--X---M-?-?-o----B----X---------------XXX-X-------?-X?-?------B-------o-MBoMM--MBXo---M------MX--B----o?B-------?-o-BX?---X----?---MM----X?Mo--M-?o--M-X-M-o-X-B-M--o-T?v
-XBB--B--------?o?B----------o---?B-X---M-o-MX?-----?MM?-BMX?-M-B-?--?----BX---------?----?B---M--M-BM---o--X----MB---?B---M------B----ooB---o--B?--Mo?B?------XX-o--------X--o-o----X?Xo?--M?-M-----|-f
---------?--BMX-----?-B-o--B--------B--------B-----M-o--Moo-o-o-----Xo-BM----?--------M?------?------oB??MX-M-M-----?--o?-B-M?-M------o--o------o-----------?---??--BX--B----?--B---?-o?------?--B-X---f
-?X--o--------X-------oB-o--?-----?-----------X-------------------?---B---MM--XM-?--XB----B--M--B--o-------?-B-MX-o--M-------oM-Mo--?----MBX-MBM----X-M-B-M-oM-X---X---?---XM-----?----o----o-o---B--X-f
---X----??-----B---X?XB-BX--oM--------XX-X-M?----?-MMM-M---X----B--B-Bo-o--oM-X----------M--B--X--B-?M-XM--o--Mo-M----?M?o-----------?M--o--B-o----XM----?-o--?M-----M---X?B--BM---M-M-B-M-E--B-----B--f
---M--ME---?----X--?-X-----X-oB--X--B-EM-----E-----o---o?X-XMM?------o------o--?-M?----?------B-------?--??----Bo------o----X?B-----M---?B---B----X--B-------------MX-----o--X-------oMoX-XB---X---M--Xf
-------M----T-----X------------------MB-----XX-X------XX----o----------X-----------------T--X--E------o------------X-------------X--o-------X-X-------X------------oo--------XX------------------------f
m-----------|X--X----X-o--------------X---------------X-----X--------X-X----XX-----------|-----B--------------------X-----X------------------X----o------oX-----------------X---X-X---M--X-X-----------X
X-X--XXX-XXXX-X-X--X--XXXX-XX-XXXXXXX-X--XXX-XX-XX-XXXX-XXXXXXX-X-XXX-XXXXXXX--XXXXX-XXXXXXXX--X--XX-XXXX-X--XXXXXX-XXXXXXXX-XXXXXXXX--XXX-oXXXX-XXXXo-XX-XX-XX-X-XXXXXXXXXXX-XXXXXXX-X--XXXXXXXXXX--X-X
