----------------------------------------------------------------------oo--------------------------------o----o------------------------------------------------------------------------------------------
-----------o----------------------------o----------------------o------------------------------o-------------------------------o-------------------------------------------------------------------------
--------------------------------------------------------o--------------------------o----------o--------------------------------------------------o---------------------------------------o--------------
---------------o--------------------------------------------o---------------o-------------------------------------------------------------o-------------------------------------------------------------
-------------------------------------------------------------------------------------------o-------------------------------------------------------------o----------------------------------------------
---?-??E-XEo--X---X-oB--MM-X-E-B-X---M-BoX?----EM--oo?--o---o-M-X-----MX?-----o---o--------B-o--X------o--X--E-?-?--B--MX-oX---MX----oX--EX--BBEXB--X---o---?B-?---BXE----B?E?-------o?--BMo-?E-M--o----
----EEB----X----o---BXBEX--XMB----------EXoM-?o-----Boo--MX---Eo-E--?o--------oBM-----oE---B-E-EEE----X-?oB-B----o--?B--------M-Mo?-----E-B-------oEE--B-----X---o-XBMEBMoo-B------M?---M------M-B-X----
-X---oX----MXM??-X-Mo---oo------oX-o-------M---?-?-X-X-----E-E--XE-o------XBE-----M-oM-----oX--E---X--M--?---E-EX--XoB-?------X---B---o--------E---X--oX-?-o----------B---XX---o---B---o--X--B-X--B-M--v
-?-------B-BE---XM------X---o-----BXE---o-------?--E-?-oX--B?-B--B--MX-o---------o-o--Xo-----BB--o-B--o--?----EXB------??-o?--?---o-XE--E------?-MM-----?---?MX----E--??B-?-BEE--?--o--o-?-E?-XM--BXo?-f
-E-B----B----?BBoB-?-?--B----X---XX--E------?-M-o------E-E-?--X----------------o-X---------Xo-o--E---M------X-XE-?--M---------E----B--------EMEoXE-?-o?---E?---o-----o-o--o---o---Mo-E--?-----o---BBo?-f
--E-MM-----X-?----B----E---?--oB------M----M---E--EB-?o-o?--------ME---?Mo?----o-o---M-----X--?EBB--M-E---MBoM-M-B-X-MMX-X------o-X-X--M--o---oX---o---ooX-----?--E-o--o----B-?-E---BBBM--Bo?-E?o------f
--o--M?---Xoo-?-B-E---o--?---o-----?-----o-MB---EBMMX-----oM------Bo----BX--XX--oo----XB?-o--ooM-------?-?-------------Xo------B---E----B?E-------E---------?E-M-X------B-?--M--o--?---X--M---?--?Eo-o-f
--EoE-----E-?X?---?--E----?--o---M---?E-o--?--?o---EXM----o?-------Bo-o?----?------o-----?M?---o---E-E--M-E---B-B--MX----Xo-EB-----X---X?--X-------?EMo---B----?--?----E----?-X------X---o---oM-EX-B-o-f
-oX-E-o-------X---E?-----Xo?----Xo-?B-o--?-B---oo?--E--oE----X-?--Xo--B---E-------?-X---X-o----XX----??-BB--X-------ooB?-EX-?----------X-o--------------o-E-E-------o-o-E--E----X--E-o??E-X---XX--EB-X-f
m-o---X----X---E------o?X----------X---o--E------?-X--E----------E---------Xo--?B-BEEBXXXB?--?B-B-Xo------X-------?-----oB-o----X----B--o--EX---o-E-o----------?--E--E-o-B?--------o---Eo--?E-----Xo---X
XXXXXXXXXXXXXXXXXXXXXXXXXXXXXXXXXXXXXXXXXXXXXXXXXXXXXXXXXXXXXXXXXXXXXXXXXXXXXXXXXXXXXXXXXXXXXXXXXXXXXXXXXXXXXXXXXXXXXXXXXXXXXXXXXXXXXXXXXXXXXXXXXXXXXXXXXXXXXXXXXXXXXXXXXXXXXXXXXXXXXXXXXXXXXXXXXXXXXXXX
