?------------------------------------------------------------------------------------------------------------------------------------------------------------------------------------------------------X
o------------------------------------------------------------------------------------------------------------------------------------------------------------------------------------------------------M
|------------------------------------------------------------------------------------------------------------------------------------------------------------------------------------------------------|
M------------------------------------------------------------------------------------------------------------------------------------------------------------------------------------------------------|
B------------------------------------------------------------------------------------------------------------------------------------------------------------------------------------------------------?
M----?-?o-?-?BB-oM?oo--o-o----BoX-XoBX-oo--M?MBoXoTo--B--oBXMBM??o-o-MM--M-Boo?XXM-MB--BoMo--Bo?oMo--MM--M?--M-XoXX?-o-----M?oo-?o-M--B-X-B?BX-Xo-oXXB-oX----BooX-MXXoMB-oMoX-B--MoTo-MooBB--X-?--ooBB-X
|M-Xo-o-X--X----X--??XMo---XX?-Mo--B-BMB?M-----M--|B---oXX-X-----o-XX--oX-o-X--?B----X?-M-BX--X-X-o-?--o---M--B-----MXEXMX-----?-----B-Xo?---ooXX-o-o-?---o---?M---M----M?--X?-oM-M|o--??--XMM--X--M--BM
M--BB-o-?M-B-B-o?Xo--o-ooX--X-o--o--o-----Mo-Xo-o-X-MMM?BXoooo--Bo?-?o--o--X-o?--oM--?-M----?-M-o-----BMoMX----X--B?BB?X--MMBM--o-XXX-oX--?--?-MMBB--o-EB-M-?-------o-o?----X----X-X-MM--o----?B--B--X-v
o??--X-B--B---o---o-o?-XXX-MM?-BooB-o-X-B--XM-o--o-o-----o-oBB??-M-o-??X?-?-B------oB-o--Xo?-M-BX-X-Bo--B-B--Bo-?X---XXM--------X?B-o-XoMo--B-------BXMM--------Bo-?-MX---B-?-B--?-?o--M?M-M----?--oo--E
?---?---oM--o--B-o--?-M?XBo---?-B?-XoMB--o-X-oM-MM?X-----M??-M----oM---B-?-X-BMM--X?-o--BX----M---oo-------?B--M--XBXMB-X---oT?-X---o-o--o----ooo?-o---oM-BM---X-??-o-o--o---o-o--M-oX----X-o----?MB?B-T
M--B--oo---B?----Moo----M-M----M--Bo---MoMo----X-----Mo---------?-?--?o-?-?B----oo--o?Xo-M------o-Boo---oXB-----o---B---X?--M|-E-?MBM?BooEBo-?XBX-o-X-MB-----M-B---?B-???MMo-M-o-X-?X---M?oB---?------o|
-?B-oBoXooB-------o?-BMB---M--M--o-XB-o-B-oo-X?M--B---M--oM--BX--B--?-X------B--B?XMX-?---MXBM--M?--XoM-Xo----?BMoM--X--X-X--X?Bo------BBM-??-B---MXXM--BBoo--X---B--------M?--Bo----oB---?-o?----?M-o-E
o--BB---B?--Boo---X-X----o---B--o?---?oo-?M?-X------X---Eo--?---?-----?----M?--?--o--?-o---B--BM----X?--o--------M-M---?MBX-----B--o--o--B-------?--------?BM--------oBoo-M-----ooo--M---M----BXo----?-X
ooo--?B---BB--?o--o-oX---X----X-?---X-BX----X--BXoXBX-BBMBBB--o----------B---oB--XX---oB?-T--T------o-oB?----B--B-?-B--------B?B-BX?--BXo-oX?--oB-Boo?X-------------To-Bo----o---oXo?-??----X------T----
mo?-o---XB--o--oooB-o-Xoo??-o--B-oXXBB-oo-X-?-o-BXo-B?--o----?o--Xoo-------?-X-BoXXo?-o--B|X-|-B?-oo?BB--o--o--o-B---?oX-oXXo---X-o-X--Bo--X--oX-o-??-XXB-o-oo--B---|X--X---o-B-?Xoo-X---B-oo-o-o-o|---E
XX-XXXXXX--XXX-XXX-XXXXXX--XX-X--XXX--XXXXXX-XXX-XXX--XXXXXXX-XXXXXXXXXXXXX-XX--XXXX-XXXX-XX-XX--XXX---X-XXXXXXX--XXX-XXXXXXXXX-X-XXXXX-XXXX-XXX-XX--XXX-XXXXXXX-XXXXXXXXXXXXX---XXX-XXXX-XXXXXXXXXXXXXX
