?------------------------------------------------------------------------------------------------------------------------------------------------------------------------------------------------------T
X------------------------------------------------------------------------------------------------------------------------------------------------------------------------------------------------------E
X-------------------------------------------------------------------------------------------------------------------------------------------------------------------------------------------------------
X------------------------------------------------------------------------------------------------------------------------------------------------------------------------------------------------------B
o------------------------------------------------------------------------------------------------------------------------------------------------------------------------------------------------------E
T|-oMBo??-MB-XXB-?M----oo-Mo--oo?MBo-o--MM?oo--oXX-oB-oXo?o--BXMo-ooEX-X-BX-o-?-Boo-X?M?XXEo---?B?--X-oBBEMXMooo?B-BMX-o---oXo---o-BooEMMooMX?o?oMB--ooXM?o-M?EM--oX-XXXM?-BBM--XM?M-B-??oXX-oBM-MB-X--M
oX-o--B--M--X-?-B---o?oM-M-X-o?-----o-X?---X-?XMo??M-oB-E-X-o-M-MoB?MoE-E-o-M----?ToM----MXMoM----oX?MoX?B---BMo--B---XX|o-o-?BoMX--o-M--M--M------?-BM---X---?-BX--?-oo--------o---------B-o---o-----BB
--Mo---?B--X?B---o-MB-B-?--X-E-M-X-oM-o-T|-oX-B-?---oB-BXo-Bo-------BMBXBXXo--o?--|M-?XB-??----|--BM----X-?-?--B------MMXB-M-----BX?BB-------B---X------MBX--BME-o-M-?--o-o--XB-----X-BBM--oXoXoMoX?T--v
MB-X---??M----o-BMM--o-B-MMMMX--M--B---XXXXB-B----X?o-BB?B--XoX-X------ME-EX-B--MMX-X-o-M--XMMMX-?------XB-?--B-X-?Xo---?-o-Bo-o--o----?--XM-----oo-?X-M---XX--M??E-B---B-o----M??XBM?----XXoX-B-o--|--?
----oMB---|o-oX-----Bo------?BB?-----o--M-M-M-o-o-M-MX----M-----oMooXBMMX?X---o----oo-----o--------B--o-M-M-o------XBB-o--Mo-B-X--oX--------?oB?M-?o--o---o-M----MB?--M---B-X-o---E---MX--M--oB-M?-oX--o
-M-B------X--MB--MEX-MEB--B-oMXB----?-BB-o----XMX--?-o------M?--X-?MoXXXM--o--?B--M--X???-XM---Eo---o?XB-B-B-B--oX-B--X?--------M--B--oo-o---M--------B-oMXM-oEB--X--?BXX?-B-E??M?M-BX-B-----M-----M-B-T
X---B-M-?B-----X--XBBM?--X-B?-X--Xoo-o---?-M-B-?-BX--B---EB---o-Xo---Mo----MM----M-?--Mo?-X-oB-X?-?-?-X-----X-o-ME--X---MoMXB?o---o--X?oM--BX---Xo--Xo----?-XXX--B-?--o-XM-MX?---BXX--?--oX-?-o--M--o-B-
?-?----B-----o---MB---o-E?BM?MB?-----o-B--B-T---E-----?MM?--?----?--E-X-ooX--EoM-------X---??------B-----oo--o-??XMBo-X--B-E--oB-??M---o--B-M|-X----oB-oX--B-B-?--o-M-?-X-?-o-?---?TM----MBB-X----M--o-o
|--??-o--B-oo?X-o--B-?-?M--o--o---oo--B-Bo--XEMMXXTo---------BoBB--o?-?-XX-B?BM---X----B-E------o---?BX-?o-B----oo--X---XBXXX-B---------B--X-X--o-TBXBX?-BB-B-?-oBB-----o----X-B---|---o--MMM?oEBo-oEX-o
m----o-|?-oX?-B?o-B-X---Bo-B?X--X-Xo-o----?B?X?-XB|X--oB-|BXX-o---XB-o--oB--o?o?-B??-o-BXMX-------?X--Bo--------?---oo-o-B-??--Bo---?--o-o-ooXo-B?|-M-o------B-X---o--X?o??X-B--oX-XX?BoB?o-o-X?-BMM?M?M
XXXX-XXX-XXX-X--XX-XX-X--XX--XXXXXXXXXXX-X---X-XX-XXXXX-XX-XXXXXX-X-XXXXX-XXX-X-X---XXXXXXXXXXXXXX-X---XXXXXXXXX-XX-XXXXX-X--XX-XXXX-XXXXXXXXXXX--XXXXXXXXXXX-XXX-XXXXX-X--XX-XXXXXXX--X--XXXXXXX-X-XX-X
