-----------------------------------------X--------------------M---------X-------------------------------------------------------------------------------------o-o-----------M---------------------------
-------------------------------------X--M--------------------X----o--------M------------------------------------------------------------------------o-----------------------------------------------X---
-----o----o--------------------------------------------o------------X-----------------------------M--M-------o--------------X--------------------------------------------o-----------M--oo-------oo---o-
---------------------------------------o------------------M----------------------------------------------------------------------------------------------------o--------------------X-------------------
----X--------o------------o---------------------M-------------M-----------------o----------------------------------------o--------------------------------------------X-----------X--------X---------X--
---MX-o---M-?X-?-MX-M?-XT-?X?BMM-BM-oXo-?---??-B-?X?---?X-----XM--?--M----?----?B?---B-BBX-??M-o-XB?--X-BBX-?B-XM?X--X---BX---?---M?-o----?X-B---X?X-o?MMX-B--oM-X?---B-X---o-BB-XM-M-o-?-XB---MXo--o-M-
-------X----o---oo-----o|B-Bo--o?-o--?XM-BB---?---Mo-XBMT---X-?o?o-----o-Bo-M?----?---M---o-o--XB----B-B----o-B----MBo--B-B----M-o---M---X----X?B--?-----MX--?--X--X-----?MBMX---------?--?-?-----B?----
--?--------M-?MXM----M--Xo-o----o??--o--X-oM-o---Bo----X|X-o-----M-?--?XM--?BoMMM?----o-BXB---o--MM---X--?--??oM--o---------BMMo-?MX-o------?MMo-oEoM?BM--MBX-B----?-?o-X-o-----XBMM-----X-oo----B--?--v
-MM-?-Mo---oX--Xo-o?-o-------X-Mo--M--------XMM-B-?----oX--BX?X--o--X----?---X--ooB-XXX------MMo--o-BXX??-X----oB?BE?oo--BM--------B-o----M---o-XXoB-----X--M--ooB---o-?--XXB---B---?---B--?-?---------f
-----M----B?XXMM?-?---BB----?X-oM-ooMB-X--?-o---o--X--MBB--M--?-----o-B---BM-XMMX-M-?-??-?--X-oX--M-oM--o?---M-B-o-M-----o-----M--o---X--?------------B?MB---M--M--?--?o-----M-o-----?X--?----oB--oMMX-f
-oB----?BX-o-Mo----BB-o-o--X-XM--M?--M?M-X-?Mo-MX----------X--o----MB--BXM--o?----X-----X-???------o---o-M--Xo--XX--X---------BE-----BM----?-MM--?X----o--X-EM-o-?-oX--E---?-------B--B--o-------o?--?-f
-?-BoB---B---o--X------?B-B-----M--M--X-M----B----M----M-XX-X---XB----------o----M--Mo-B----o?-X--o-XXoMMMX-X?XMX-MX------XX-M-B---------MX-----Bo-ooB?-XBoBoB--M-X-M-XMoX-oo-----------XB------X----o-f
---oB-?-XoMX-----M---M----o--B--------MBoX-----XXM---M-o?M-BXBM--o-?BB?-X??X--M-----oMM-o---?--MXXM-BX-oX--M-o-----B--X-B---o?MXB-XBX-BX--XoX-MMo-X---o?-oo-X----?oB--o---?-B--MM?B--M---E----------E-Bf
--o--oo------o-----------o-----------X-o-------X-o---------------T--T-X--o-oX----X-E--o--X----------o-Xo---oo------------X--X--X-------o-----oo----XT-o-E-----o----------M--oo-oX-----X?BMX-ME-X----?--f
m-----------------o---X------X---o--X---o----X----o-------o--X-X-|Xo|--------------M----X----X----o-----X--X------X-XXo----XX--X--X--X---M------X-X-|--?B------------------------------o-----M---X--?--X
XXoXXX-XXXXXXX-XXXXXXX-X-XX-X-X-X-X-XXXX--XX-X-XXXX-XXXX-XXXXX-XXX-XXXXX-XXXXX-XXX-XXoXXX--XX--X-XXXX--XXXX-XXXX-X-X-XX--XX--XX-X--XXXX-XX-M-XXXXXXXXoXXX--X--XXXXX-XXX-XXX--XXX-X-X-XX-X-X-oX-XX-XXXXXX
