T-------------------------------------------------------------------------------------------------------------------------------------------------------------------------------------------------------
X------------------------------------------------------------------------------------------------------------------------------------------------------------------------------------------------------?
M------------------------------------------------------------------------------------------------------------------------------------------------------------------------------------------------------?
X------------------------------------------------------------------------------------------------------------------------------------------------------------------------------------------------------|
|------------------------------------------------------------------------------------------------------------------------------------------------------------------------------------------------------B
XBo-?-?--M-BB--M?M-BMXB-B---?Mo-o--?o?MB?--oBMX-oXo-MoB?o?XB-B-o----M-X?-o-B?B-?T-XBB-BM-EoX-M-XXoM?-?o-XMoBB-o?M-XB-o-M-?-MBoB?Bo-XBE|--o?o?--M-MEBoMoBo?BXoo-X-M--BXo-Xo?B???-X--o-?o-?-B?B-M?Mo--MM-T
--o--?--B----o----?--E-B--M?--?X-oB-M----o-X--o---EM-o--M-M-o-B--B-o-----M------|oo--B---BXB--oM?---T--------M---oo-o-?---o--X---X?MXBX?---B--o-MMB-?-o-?---M??-M----XB--X-----BBB--M-?B---------?-M--?T
M--B---X--Xo--M-Xo--XB------Eo-oo--X-o---X--B-B?M??--M---o-oB---o-MBoMMB----BB--XMXM?-oMB---?BB-----|?o?o-o-?-XoMoXo?---o-BB--o------Bo-o-----XB-----Bo----o---o--MB---EXBX--o----M?----X?M--oo---M-M--v
M------M--oMM--o?M-o?BX-BoXXB?o-M??-XB-BoX------------BB-?B----M-o--o---BBoX--?-o-X--??---Eo-----o--X-o-E-BB--BX-oMo-?-Boo--oX?-XB-oo-M-MoX-oMo-M-oBX-?B-BXM?--Xo----?XBMo-X-?--oX--BoE----?-MoX-?-M-BX|
M-X-oo----B-BXMMMXXM-----oo-M-BX--o?--M-MM---Bo-B?--?---B---o-o-?M--o--X--X--B----X-----X?BM-??B-TB---BM?M---o---?-X-----o-BMo-Bo------o-?--------o-oM----B----o---M-XBM-?-o---MM----MX-oXo-o-oX-------|
B??o?--E?M---Bo------o-o-??--o-MM-o-M--B---o--B?--?--BEX-?--B-M---o-X?-M---M---X--B-oB-B--o-X---XX----X-X-X--XMBo-XMMMBoEB?--B--T-E??-BXB--B--M?X--oM---Mo--M-MM----Bo----oXBM----EBo----MB-oE-M--oX---T
M--M-M?X----o-Mo?o-BMMXX-----M---B-o------?-M--MB---T-MBX-o--o-Bo-B-B-o-M-M-o--?Mo----B----X?B--E-E--B-XX?-o-----?o----?M--o-MX?X?B----o--------X?B---XM-M---M----?---??o-M------B?-?-MB?--MXB?--X?B?-oX
Xo----?B?--M-M-M-oM---B?BXBo--o?--ooB-?o---E-----?BX|MX--Bo-BB--MB-B--M--?--Xoo----oo-----oB---?MXM-----B-BB-?EXX-B--XX-X--X-M-BMBXM-?-?X-T-oo--o--M--o---oBB-MX-----o--X--B-----?M--M----M--BXXXX---o?T
TB--------X-X---X--o-------BB-?--o---B-o-?XMM---o--?X-X-B--X--TB--o-?---B--XEXo---oBBX----B--EX-oXM-Xo-?------M-?--?-X?XB??Bo-------?-----|?-?X?X----o--X-X----------?-Bo----XoEo--?--BoX--oB-XXEXM--T-M
m-oBXMXMX-XX-o?Xo?oooX-oB-o--o---B-Bo--X-XXB-o--BoB-X------B-o|-o----o-?---X?-?--XB---oooo-X|B-?-?-oXo---|o?|XB--X?-BB--X-B-B--o--o--?o?oBX-o-B-?Bo--X---o----o-o-X-B-o-B-B?o?X?M??-BB-oo--o-XoBMoooo|-M
X-X-XXX-XXXXXX-XX-XXXXXX-XXXXXXXX-X-XXXXXXX-XXXX-X--XXXXX-X-XXXXXXXXXXX--XXXXX-XXX-X-XXXXXXXXXXXX-XXXXX-XXX-X-XXXX-X---XXX-X-XXXXXX-X-X-X-XXXX----X-XXXXXXXX-XXXXXXX--XX-X--X-XXX--X--XXXXXXXXXXXXXXXXXX
