--------------------------------------------------------------------------------------------------------------------------------------------------------------------------------------------------------
--------------------------------------------------------------------------------------------------------------------------------------------------------------------------------------------------------
--------------------------------------------------------------------------------------------------------------------------------------------------------------------------------------------------------
--------------------------------------------------------------------------------------------------------------------------------------------------------------------------------------------------------
--------------------------------------------------------------------------------------------------------------------------------------------------------------------------------------------------------
-XXM-?-BM-B?-M---BX?---XX----B-??-B-----?-o?--oMM--M--M-?--MX?--?MM-?M??-M--?-M-B--M?---?-?-XX---------MM------X-o-----B----MB--MBX-?-M?-o-?XM--XX---BX-?-BB-oM--M?--XEXMX--M--Xo?X--TMo??-BE-B?B?M?----
----?o----o----?--o-??-?-?BM?-M----M-M?MoBB---X--T---?-B-BX--oo?-----o--?o-----o-------M-----B--XB--?XB---o?-BXXBM--M-B--M?M--?------o--X-Mo-oB-?-o---M-oB--BM-X---X-XB--?--oM?BM-M--|o?o--XXo--------?-
-M---oM?XX----X---MX-----oo-o?----B--------B?--XB|----M--oMXo-Mo--X-Xo-o------TB----B-Mo-X------B-?----?------?--oXX---MB----?-M--MB?M-M----o--Bo-MXXB-X--M--o-XX---XX?X-oXE-----Mo--XX-X-M-oM-B-B--B--v
-o-o---B?--X-?-M----M---X--M--?XB---?--?-----XM--XMM-B------?X--X-M--XX?M---B-|--M---?-B--BM?Bo---oX?-XoM?--B---M-X--------M----?-----?--o--XB---o-?o----o-M-----M-B----?-XX----M--X----oo----?o--B--o-f
--??-M----Xo?----M--o-X-M----------X----Xo?M---?--oooo-M-----M-MoM-B-?--oM-X--X-ooM------Moo-oBBX--M--?M-----X-X-E?--?B?---------B-X-----X-X-o-X-BX-M--M-M--?--X-o?-o-------B-----B---??B?-?---X?--XoX-f
--X-o----BBBo-?--oXE-----?B-oMX--o-M--X--Xo-BX--BXo-B--------o--?-B---?-?-BB-XEBBMo-??--?--M----X-B-------B--?--BX-?---------B-M---MX----?-oB---o-B---X-X---o---oB-M?B-M--B------M-MX---o----Bo----X--?f
-?-BB--?Mo-o-B--?-XX?----o--B-X?-B?-MB-?-oo---X-o?MB-XB-o-M-?XM-o-o-X-------MM?---XX-------oB-------X-Mo------X--?X----XB?-------M----BM--MX--?M?--XXM--o--Bo--?X------oM?-M--X-?o--M--X-B-o?-?X-B-XBM-f
---E-----X-XB-X--?-X-BE-------?-o---o-Mo-BX?-?M---oo-?o-XM-----B-?-?----Eo--Bo?-o--?---------M-----M-X-?-M--Mo?XB--?-XBB----MM-BM--X-E-----------------B-?--M---B-?---B---X-M-?--X-----?o--Xo---B--Moo-f
-MMX-----M-----X----BMX?X-------------------X--X---------o-----o------XXM--Xo-----X-X--X--------o--o--o-------o--B-o---o-----------To?-----T---X-X----------------o---------o-oo---E-------------------f
m----BM---o---X---------B-?-----------XXoo------X----o----o---------o----o------X----------X-----XB----X--X-X------B-----X-----X-X-|-o---XX|-----XX--------------X-X------o---o-X-XMX-----------X-o-o--X
XXXX-X--X-XX--XXXXXX--X-X--X--XXXXX--XX--XXXX-X-X-X-XXXXXXXXXXXXX--X-X-XXXX--XX-XXXXXX-X-XXX--XX-X--XXXX-X-XX--X--XXXX--XXX--XX-X-XXXXXXX-XXX--X-XXXXXX--XXXX-XXX-X-XXXXX-XXXXXXXX--XXXXXXXX-XXX-XX--X-X
