|------------------------------------------------------------------------------------------------------------------------------------------------------------------------------------------------------o
X------------------------------------------------------------------------------------------------------------------------------------------------------------------------------------------------------X
?------------------------------------------------------------------------------------------------------------------------------------------------------------------------------------------------------B
E------------------------------------------------------------------------------------------------------------------------------------------------------------------------------------------------------M
B------------------------------------------------------------------------------------------------------------------------------------------------------------------------------------------------------T
X-B-B--B-Mo-o?-MMBM-oM-oX-BoXo-ooo-BoBE?---BT?--M?--M?B?E-----o?B-B-M?B--oX-??M?ooo-Bo--?EoM-?-?BB--?Mo-XoBM-oo?o-XXX-o--?--ooMM??oo-?oXE-XMXBo-o--?B-E-Boo-XoooB-X--Mo?B?-?o|-MoX-M-BM?MoB?-???B---oB-E
TB-o-?M---??M-E-----o--X-o--XM-Xo-o-MXM-o-X-X-?-------XMBB?XooX--E-M------XB----E-Bo---?BXX---M---Xo---oBB--ooX-M?-M---MB-MoXB----M-o--??-X-B-?--??-X?M?-Xo-XoM----M--B---M-MXB-BM--o----o--o------|?-o-
---X----oM--MMXB--X?M?oB-MBMM---XBX---M-ooo-oX-B--ooXXo-X|--??---?--oB??-o--B-BXXB---o-----BM-----o?M?B--X?-------X-o-o--M-MM-BB---o???-X-?o---?X----BEMo--oBE-EB------MX----?-o--M-Xo--M?---o-o--XX-o-v
|--oB-o---MMX-X-XXX---o-------B?E-oM---o-X?BM?B--XMMM-BoBX-X--MoMB--B---?M-M-?--?-?-EXo--o----o--o-------?M--ooMB--o----B-X-------------?--?-?o-?-o-MM?-?o-B?XMM--B--M---?o----M-X-XB------X---X-?XX?M-|
E?oB--o-MB--M-?o?----M----X-BX-?B----Eoo-?---B-ooB-----o-oooX--M-M?o------o-B------?BBBX-ooBXoX-MX-o-M-MX---o?X----oEMBB----Bo--?o-?M-Eo-|o-?-XX---BB-?--oB-B---MX-oo--oo-X?--M--X-B-??XXMMB-o?-X--o---M
|-M----M-----B-M--?-?-X-X-----XoBo-BBXB-B-??--MoM-XM-Mo---XXM-o-B--XooMBM--X-----MXMo--B-E?--Xo---?---M-Xo--o---M---M---oEoB-?-------?M?-X-o-oX?o-B------X---?X?----?XoBX---o--BoB-----B-M?Bo--o---oB-B?
-?--BB--M-?-M-M--M------B-MXooMB--?----M----?o--------Bo---M-MM-----?X---o?XX-E-?--?BB?-BM-?-?X-----B--BM??oB--BooooX-MMBXX----o-BX--M----Mo-B---XMMMoX--oX-?-B-o-BM-XB-o?MMBo-----B--o-B---XMMMX--o---M
M--M-------X??------o-X-----X---o---X-B-BoX|-BM--BMBX--X-MB-o---B--?-Bo-o--XBBBX-X-XoBo-XBB-T-oEMBoB-|-----B-?--M?-B-M-XX-----?X--ooE-?o-o--o--??XM-----o-X----XM?------M--M-XoBo-M-?oMo--MM----oXoMM?XX
|---BX-B-oo-?X-?-B?-------oB-o-----o-----?oXo--oB---?Xo----?--?--??-?----o-B--?--oBB--XE----|??M--o-oXo---?---------B-?oBM?MB---B-BM?--X--BBXB-B------Bo----------o?|-Bo----?---X------o----T?-??o?---B|
m--X--?-o??--oo-oo--o-oBB---o--ooX-?o-X?B-BoXXoo--|X--o-??o-B---B----X--B?-----ooB--o?BMMX-BX---??X---B-B?--?-o-o?X?---o-o??-?-X-o--B|-Bo-----o--XXo-o-oXB-BB||XX?M-|?-oooB?-?B?B-?-Xo-Bo-X-|------X-?-o
XXXXXX--X--X-XXXXXXXXXX--XX-XXXXXXX-XXX--X-XXXXXXXXXXXXX--XX-XXX-XXXXXXX--XX-XXXX-XXXXXX-XX-X-XX--XXXX-X--XX-XXXX-X-XX-XXX--X-XX-XXX-XX-XXXXXXXXXXXXXXXXX-X--XXX-XX-X-XXXX---XXX-X-XXXX-XXXXX-XXXXXX--XX
