?-------------------------------------------------------------------------------------------------------------------------------------------------------------------------------------------------------
?------------------------------------------------------------------------------------------------------------------------------------------------------------------------------------------------------?
X------------------------------------------------------------------------------------------------------------------------------------------------------------------------------------------------------|
X------------------------------------------------------------------------------------------------------------------------------------------------------------------------------------------------------X
E-------------------------------------------------------------------------------------------------------------------------------------------------------------------------------------------------------
E-Xo-XE?oME?MXo-oo-X?EE--?XoooX-?M?Moo---Xo?--Moo-?XMX-?E?MXEB--EMEMB-E-EMXBBBX--o--E?---BM-EB-B---B?-BE?M-XMBMoEXMo?X-XXEXo-XBoEooX-Eoo--X-MEM-BXBMo-M-oX?oE-MoX-M-BM-EEXo-oo?XoXEXoo-M?o-oo-EoMMoBoB-o
TMMBMo-?BXMBEo-XB-?-??X?-BoBBB??o--o-EEXM-oo--MXB--EMX---ooBoM-MBB-?--E-??oo---o-B-B?Mo-?X?-o---o---EoB--oMEXEEo-EoE-------Mo--B?XooMo-X-BMM?XXEoME-E?-o---?oE-Mo-BBE--o?M---BMoo?XMEo?-M--EX-M--E-Xo--?
--o-XEo--o-?oo?BoXo??Eo?-?MoXEMME--B-?Xo-Bo--BBB?EX?MMBEB?Eo?E?---?MXM-XXXoXEMB-o----Moo--o-o-MEE-E-XMX-X??BBEXBM--EM?----B?M-X-MBB---o?oo?B-o-M?E--BMB?oM-X--EXB??B-MMX-BE-E?-X------XoX-oM??BoEMXMoBov
?BoBEXMBB-BX-X-oXo-o-ooMM--EoB-oXX---BMBoB-BX-M-???MXXEoEB-??--MEooMEMB-?E-M?X?o--oM-o--MB-XBM?BoMB---BEEoo---BBBo---BX-o-B-?Bo---Eo-Xo-o---?-X-EMB?MM--?-oBEM----XoEX-MEMo-B-X-oEBMBB-?-BBX-?X-B-ME-XX-
|ooBEEM-MEMM-?B-oo-M?-oM?-oBMXB-?-B-B?o?EoE----XM?-oo-?-E-B--EBEo?-?o-oBB-oX-?MXo-MXXXBM-oX?-E?-o?M-Moo-oEE?o-o-ooM-oo?BEXX--BoEX-o-o-E?oE-X-EooBBo??-EBB?oMoEoB-X--o-XM-Mo-B---?MMXoB-BoE?M?-E---?BMBoM
EB--oBBX-XoBM?---EXoMo--BB-?XoB-X--Xoo-XEoXEX-oM-ooE-B?-E?-BMBEX-XoMX?oEB-Xo---ME--EBXXMoB-MX-?XoX----?B--XEX-EXB-o-?E---MB?Xo?X---oB-XX-XM-E?EXX-o-?M?BX--BMEEo-EMMEooMo?EB-Boo-ME-B-?MoBEXME--?EoEX-B-
?--X-BBXEMo----?--oBoXMooo?-MBBE-MB??-oBEMBB?-M?XEoE-BBBEEBEE?BM?E----?MME-EMoBMo?MX--?B-B---EoM-BXMXXEMoEEEEoXo-ME?B--?EEE-X-?--oX-XXo-B-MBXB--B-----M--oEXBE---oXMoooo-BE-EEXXMMMooME-o-Mo-EX-BBo-BMXB
MXB-?oBB-oM-EooB-XX-oXXEBE?Xoo-B--BooBEXooMB--oo-?-oooooB-X???o-?M--Boo-BoBoXM-oBMXBE?-XEXBMM?o-XooME--XBo?M?X-BoM-Mo?-Xo-M?Mo-M?-oMXE-ooEEMX?B---o-Mo?BEE-?-X-?oMB-BBE-?o-XoX-Xo?MXX-EB-MBMEEBXM--BEBEo
X-ooEBB-E--?-X?X-X-B-B-XBXBBX--XX---oooXoXXB---EBo--oBB?oB?ooXo-XB-?--oo?o--oB-X-X---B?XXX-Bo--o-EEo-o----E-----X-Bo?E?o--o--o-XoEBB-B--oEEBBB-X-??oX?EXB-o--EBo---o--???--oBBX-?EoXoBo--?Bo?--oBo-X-o--
m-E?-oE-B?X?BEX--?----?-?X-Bo--?--?oXB-o--BX--B?X-oEo---EEoBoBoB--oEo----XE--oo---XX-XXBB--?---E--B--?Xo?-----Xo?X??-o--Bo--o--B?oX-EXoE---o-??oEBXX-oB-oB-BE--E-XoEX-X-X---?B-?----oX-oo?X-E??B--B?-BoT
XXXXXXXXXXXXXXXXXXXXXXXXXXXXXXXXXXXXXXXXXXXXXXXXXXXXXXXXXXXXXXXXXXXXXXXXXXXXXXXXXXXXXXXXXXXXXXXXXXXXXXXXXXXXXXXXXXXXXXXXXXXXXXXXXXXXXXXXXXXXXXXXXXXXXXXXXXXXXXXXXXXXXXXXXXXXXXXXXXXXXXXXXXXXXXXXXXXXXXXX
