?-------------------------------------------------------------------------------------------------------------------------------------------------------------------------------------------------------
?------------------------------------------------------------------------------------------------------------------------------------------------------------------------------------------------------?
X------------------------------------------------------------------------------------------------------------------------------------------------------------------------------------------------------|
X------------------------------------------------------------------------------------------------------------------------------------------------------------------------------------------------------X
E-------------------------------------------------------------------------------------------------------------------------------------------------------------------------------------------------------
E-X--XE?oME?MXo-oo-X?EEo-?XoooXo?M?Mo----Xo?--Mo--?XMX-?E?MXEB--EMEMB-E-EMXBBBX-----E?---BM-EB-B-ooB?-BE?MoXMBMoEXMo?X-XXEXo-XBoE-oXoE-o--X-MEM-BXBM--MooX?-E-M-X-M-BM-EEXo-oo?XoXEXoo-M?o-oo-EoMMoB-Boo
TMMBM--?BXMBEooXB-?-??X?oBoBBB??-o--oEEXM-o---MXBo-EMX---ooBoM-MBB-?o-E-??ooo--o-B-B?Moo?X?-o---o---EoB---MEXEEooEoE-----o-Mo--B?X-oM--XoBMM?XXEoME-E?-o---?oE-Mo-BBE--o?M---BM-o?XMEo?oM--EX-Mo-E-Xo--?
--o-XE---o-?oo?BoXo??E-?-?M-XEMME--B-?X--Bo--BBB?EX?MMBEB?E-?E?---?MXM-XXXoXEMBooo---Moo--o-o-MEE-E-XMX-X??BBEXBM--EM?----B?M-XoMBB---o?o-?B-o-M?E--BMB?oM-X--EXB??B-MMX-BE-E?oX----o-X-X-oM??BoEMXMoB-v
?B-BEXMBB-BX-X-oXo-o--oMM--EoB-oXX---BMB-B-BX-Mo???MXXEoEB-??--MEooMEMBo?E-M?X?o--oM-o--MB-XBM?BoMB---BEEoo--oBBBo---BX-o-B-?Bo---Eo-X-oo-o-?-X-EMB?MM--?-oBEM----XoEX-MEM-oB-X-oEBMBBo?-BBX-?X-B-ME-XX-
|ooBEEM-MEMM-?B----M?-oM?--BMXB-?-B-B?o?EoEo---XM?-oo-?-E-B--EBEo?-?o-oBB-oXo?MXo-MXXXBM-oX?-E?-o?M-Mo--oEE?ooo-ooM-o-?BEXX--B-EXoo-o-E?oE-X-EooBB-??-EBB?-M-EoB-X----XMoMo-B---?MMX-B-BoE?M?-E-oo?BMB-M
EB--oBBX-X-BM?--oEXoM---BB-?XoB-X--Xo--XE-XEX--M-ooE-B?-E?-BMBEX-XoMX?oEBoXo---ME-oEBXXM-B-MX-?XoX--oo?B--XEX-EXBoo-?E---MB?Xo?X---oB-XX-XM-E?EXX-o-?M?BX--BMEEo-EMMEooMo?EB-Boo-ME-Bo?MoBEXME--?E-EX-B-
?--X-BBXEMo----?-ooBoXMoo-?-MBBE-MB??-oBEMBB?-M?XE-E-BBBEEBEE?BM?Eo---?MME-EMoBMo?MX-o?B-B---EoM-BXMXXEMoEEEEoX--ME?Bo-?EEE-X-?--oX-XXo-B-MBXB--B-----M--oEXBE--ooXMoooo-BEoEEXXMMMooME-o-M--EX-BBo-BMXB
MXB-?oBB-oM-EooB-XX-oXXEBE?Xoo-Bo-Bo-BEX-oMB---o-?-oo-ooB-X???o-?M-oBo-oBoBoXM--BMXBE?-XEXBMM?o-Xo-MEo-XB-?M?X-BoM-M-?-Xo-M?Mo-M?-oMXE-ooEEMX?B-----Mo?BEE-?-X-?oMBoBBE-?o-XoXoXo?MXX-EB-MBMEEBXMo-BEBEo
X--oEBBoE--?-X?X-X-B-B-XBXBBX--XXo--oooXoXXB---EBo-o-BB?oB?ooXooXB-?--oo?o--oB-X-X---B?XXXoBo-oo-EEo-oo--oE--o--X-Bo?E?o--ooo--XoEBB-B--oEEBBBoX-??-X?EXB-o--EB---oo-o???--oBBX-?EoXoBo--?Bo?-o-Bo-X----
m-E?ooE-B?X?BEX--?----?-?X-B---?o-?oXBo---BXo-B?X-oEo---EE-B-BoB--oEo----XE--oooooXX-XXBB--?-ooE--B--?X-?--o--X-?X??----Booo-o-B?oX-EX-E--oo-??oEBXX-oB-oB-BE-oE-XoEX-X-X-o-?B-?-----X-oo?X-E??B--B?-BoT
XXXXXXXXXXXXXXXXXXXXXXXXXXXXXXXXXXXXXXXXXXXXXXXXXXXXXXXXXXXXXXXXXXXXXXXXXXXXXXXXXXXXXXXXXXXXXXXXXXXXXXXXXXXXXXXXXXXXXXXXXXXXXXXXXXXXXXXXXXXXXXXXXXXXXXXXXXXXXXXXXXXXXXXXXXXXXXXXXXXXXXXXXXXXXXXXXXXXXXXX
