--------------------------------------------------------------------------------------------------------------------------------------------------------------------------------------------------------
------------------------------------------------------------------------------o----------------------------------------------B-------------------X------------------------------------------------------
-----------------------------------------------------------------------------------------------------------------------------------------B---------------------------------------------??????-----------
-----------------------------------------------------------------------------------------------------??-------------------------------------------------------------------------------------------------
--------------------------------------------------------------------------------------------------------------------------------------------------------------------------------------------------------
--------------------------------------------------------------------------------------------X-----------------------?-----BBBB-------------------------------------------------------------------o------
--------------------------------------------------------BBB-----------------------------------------------------------------------------------------------------------------------o---------X-----------
-----------------------------------------------------------------------------------------X-------------------------------------X-----------------------------------------------------------XX----------v
------------------------------------------------------------------------------------------------------------------------------XX----------------------------------------------------------XXX----------f
-----------------------------------------------------------------------------------------------------------------------------XXX----------?----------------------M----XXXXX--------------XXXX----------f
----------------------------------------------------------------------------------------------------------------------------XXXX--------------------------------------------------------XXXXX----------f
---------------------------------------------------------------------------------------------------------------------------XXXXX-----------------------------------------------?-------XXXXXX----------f
--------------------------------------------------------------------------------------------------------------------------XXXXXX------------T---------------BBBBB---------X-----------XXXXXXX----------f
-------------------------------------------------------------------------------------------------------------------------XXXXXXX------------|----------------------------XX----------XXXXXXXX----------f
m------------------------------------------------------------------------------------------------------------------E----XXXXXXXX--E---------|---------------------------XXX---------XXXXXXXXX----------X
XXXXXXXXXXXXXXXXXXXXXXXXXXXXXXXXXXXXXXXXXXXXXXXXXXXXXXXXXXXXXXXXXXXXXXXX------XXXXXXXXXXXXXXXXXXXXXXXXXXXXXXXXXXX--X---XXXXXXXXXXXXX-------X|XXXXXXXXXXXXXXXXXXXX------XXXXXXXXXXXXXXXXXXXXXXXXXXXXXXXXX
