?------------------------------------------------------------------------------------------------------------------------------------------------------------------------------------------------------o
-------------------------------------------------------------------------------------------------------------------------------------------------------------------------------------------------------|
o-------------------------------------------------------------------------------------------------------------------------------------------------------------------------------------------------------
-------------------------------------------------------------------------------------------------------------------------------------------------------------------------------------------------------|
T------------------------------------------------------------------------------------------------------------------------------------------------------------------------------------------------------E
M-oMB---o-o--oMoBo----B-?oo?M-M-MXoo--B-?--o?-B?----M???X?-o---oMMXBoooMXXB-?o--o-oBoMo----B?o-oBo?Xooo-oo--M--BXo-B--X--o-BX-ooo?---M----M?-o-M-??MX--o-Boo?o--oXM-oBX--?-?-XoM-o--?-ooMMBB-oo-o?o-o-MT
oo--o--BM-X?XX-X-XM--B-o-B?ooX---X-XB-o--B-B-M--oo?-----?--B--B?o-o-XBooB--BoB??-BBo?-M-XM-----B-X-X?B?o-X----?--------B-M?--oMM---oB--?-o---M?-M--oo-oBM-BXoMooBM--M-ooXooo-oX-MM?--XM?----XBoMMo-oBX-E
XM-o--?-----XB---ooM--o??----Mooo?-----MB-BoX-o-o--o-?oX-M---Xoo--Xoo-?o-----o-oo--o-B-o--X---o-o--oo---oMX----Mo-?-M?------o---?--Bo-Mo---M---MooM-?M---ooX--Xo------?--M-?MM?-o--XX-o-Bo-----o-ooBo?Bv
T---o-o-Xo--Bo--oo--oX---?BMo-BB----oo-----M?oo-MM-M--MX--oo-oo--?-oM--M-o?---o?M--oBo--?oXM-X??----XoB-?-B---M-X--B-oo-o----B-B-??----?XX---X---oo--ooo-oooooMoM?oooBo?X-M---o-o--?--Mo---B-?o------o-?
T-MBM--------MB?BooMB-??----B----??-MBo---o--M?o----B--XB?Xo--X?--oX-Xo------?M-oMMMo--o-M?-Bo--?oo-o---oM---?--oB?--MB-M-oM-------MX?M-oM---oX--B?-MB??ooo?o?-oo-?MB---oo--M--B-oo-ooo---o-o-B---M----o
oo-o-B-X-o--o-o-------o-o-----oMM-oX--o?Xo-BM----o--ooo?--o-o--o?M--o---oooo--o---ooMMo?---o-?----Bo-M-B---E--o-B--oo--MoBM---o--oo-B--?--X-oM?oM-------BBB-?-ooo?---B--BMo--B--oX---?B----MM-o?B--X?--M
oM-MX-oBX?--?oB--X-Moo--?-Mo--B--o-B---------Mo?-Boo?B?-oM?-?MoM---MMoo-MBX-B?------o-Bo?B-BM--o?--M--?-?--BX--X-X-BB-------XMM?oMoB-o-oo-Mo---M-----XoBo----Boo-oo----B----?-ooX--oo----o-o----o-oB-??X
M-M--B-o-o---X-X-X--M----o-Bo--B-M---ooo-o?-----o------o------Moo---oMBM---?-o-o--Mo-M-o------?X--o--ooM-o--MXoE--X-----MBXM---o--M--o?oX-oX--o-?B--Moo-B-?X---MXMoEB-oo-X----X-MM--?o-X-Xo-------X----T
-ooEoo-----o-----oo------o--T---Xo-o-X-XE--ooo-o---------ooXoX--oo------o------T--------o-o-XX------oX---------?X---XXoo------------X---o--X-X-------oX-------oo---M--X--------X-o---o-oX------oo--ooo-E
m-BBoXo--o-X---o--ooo----Xo-|oX--oo-oo-oBoo-oX-o--o-ooo-----o---X--o-o-o-oo-oo-|o--o--oo--o-o-oo---oXXo-o----oX---o----ooooX---o--oo----oo--------o-o-oo-X-o-o---X---o------oo-X-ooo-o-oX--oo---oo--Xo-?
XXXXXXXXXXXXXXXXXXXXXXXXXXXXXXXXXXXXXXXXXXXXXXXXXXXXXXXXXXXXXXXXXXXXXXXXXXXXXXXXXXXXXXXXXXXXXXXXXXXXXXXXXXXXXXXXXXXXXXXXXXXXXXXXXXXXXXXXXXXXXXXXXXXXXXXXXXXXXXXXXXXXXXXXXXXXXXXXXXXXXXXXXXXXXXXXXXXXXXXX
