---------------------------------------------------------------------------o----------------------o-----------------------------------------------------------------------------------------------------
---------------------------------------------------------------------------o-------------------------------------------------------------o-------------------------------------o-----------o------------
-----------------------------------------o-------------------------------------------------------------------------------------------------------------------------o-o----------------------------------
---------------------------------------o-----------------------------------------------------------o--------------------------------------------------o--------------------------------------o----------
------------------------------------o-------------------------o------------------------------------------------------------------------------------o----------------------------------------------o-----
-------B------M-----??----B?M---EM-------?-B--B---B-Xo-X--o---o-o?--E----X--o?---o-?-------o----E?M-M?---M-MM-X--?-------------BB----B-X-E?oM---?X---o----o--X?--o---X-M?---Mo----MX------o-?X--o-?-----
-BBB-o----XBo?-?-o---o--------oB--oX-?M----------E-M-----X--M-EB------Mo-XEo------XB----X-?--BE-X---------------X-?--XooM-------------B-o-M----XoM??BB-----X---X-X--?-o-----o-XX----XE-E----X-o-X-------
---X-Mo---oM--E-Eo---?B-X-M---E-EB------o--Eo-o---E?-?-o--o-M--M-EX--B-E------X-------XE---o---?--?o-----?E-B-MEX--X----?Xo-E--?E---oE---XX-----o-XE-?---Mo-?EE--B?---oBX--X-ooE--BMX---B---M---oM-----v
-E-BM-M-----B--o-XX-BoB--X------X--------X-o-ME-o-o?E-BX-B---E----------?-XMB-E---M--M-?-o--X-B-----ME------oX----X?B---B-Xo--oBXM-B---M----E-E-M--M----?-o----BE---oM-oB-M---o--oB-----?---?-----Mo---f
----B--o-----B-B---MBX---M----M----M--X?------M-------X-?--------M---BB--B-?-?-----M-----MB-----?--X-ME--XoE?------XE--XoX-B--------MB----BM-?E-----B----o-oX-MXBo-----X-E-------B-oMoE------------X---f
-?---Bo-oB?E--X-BM-o--o--------M-B--M----?EM----?oX--oX-o--------X-o------B-M--B----B-o-oB-------oXo----E---Eo----B----o----oM-EM--oM---o-X?X---XoX---?-B---X--o--E---o---X--E---?-oE?E-X-X---?---o----f
-------M-M-M------o?--------oX-----o--M-EB--BB?---E-X?---M----?---X-----MM-MEE--------MMo--XEE---o---X--M--?---?---M?o?----B-o------o-M----X--B-M-?---oX--o?--XBM-XE-----o--B---?E-B-o?--M--XM-XXoX----f
-MB-----M-BB----X-----oE---Bo-M-?o-XXM--o--oEE-----BB--M-?----B-----E---oX--?-----E---EXB-oMX?oM--------E-B--------E-Eo--o?--?-oB-X---o---E---E-E?---?X--o---?--BX-------X?EoEo--B------X---B-?XX??--X-f
--?--E--Xo-o----EXo-X---E--B---Bo-?--EoEo-?---Bo?o-BX---X----?-----B---B-?B----E---E-----B----EoX------B----oX----?Eo-X-o----?-------X------------X---B--------E----B-------B-E--XEo----------E------?-f
m-B-Eo----X---X--------o-----X---E-XX-X--------XE--E------X-B?-X---B------o--------E--E-E-X--o-------o---o--?---o--B--X-?------E?------?---?-B---X---BX-------------E--E?-?----?--------o---X-B-----o--X
XXXXXXXXXXXXXXXXXXXXXXXXXXXXXXXXXXXXXXXXXXXXXXXXXXXXXXXXXXXXXXXXXXXXXXXXXXXXXXXXXXXXXXXXXXXXXXXXXXXXXXXXXXXXXXXXXXXXXXXXXXXXXXXXXXXXXXXXXXXXXXXXXXXXXXXXXXXXXXXXXXXXXXXXXXXXXXXXXXXXXXXXXXXXXXXXXXXXXXXX
