--------------------------------------------------------------------------------------------------------------------------------------------------------------------------------------------------------
--------------------------------------------------------------------------------------------------------------------------------------------------------------------------------------------------------
--------------------------------------------------------------------------------------------------------------------------------------------------------------------------------------------------------
--------------------------------------------------------------------------------------------------------------------------------------------------------------------------------------------------------
--------------------------------------------------------------------------------------------------------------------------------------------------------------------------------------------------------
--XMBMBT--B?XMBXX-??M----?MX-M?---MB-MM---X--X---M-?M---M?-BX-----oTM--------?X?-----MMM----B-------X---?----X----?M?B-X--BM-XXM-B--?BXEMM-M?--M----oM-?---MB-XB---X-B-MM--?X---B--MBBB--B---M----X---o-
-------|oX----oX-?-----??-o?--o-B--oB-o?-M--M--X--X-oMXM--M--MM--?-|--?----?o--o--X-----X-?---XB?-M-?B---B--X-MXX--o--B?B---XXo-?-X--MM?-oX--?-oTBM-B---?-Xo------XMMoM--B?-B?--oBBo-o-BB-MX?-B?M-oB-o--
-B-o?M-X?MMXo--BM-?-o--o--M--XM--E?--?-------BM--X---oMoX-oMB--?--?X-----M?-------M-XM--M--BM----X---------------B-?----oo-X-M?Mo-----o--MX-----|-o--Xo----Mo?----X--?-----X-o-B?-o-o-?-o----B-o--B--XMv
------B---o-?B-----B---B---oo--XX?------------------?-o-BX----?o-?-M-X-M-o-X-------M---?--X-o------X--Xo--B--BXoM-------?MXBM---?-M----o?--X-o-?X-----X-----M--o-XX-?---B--X?B---XMX?B-?X--BB----Mo---of
--o-MX------o-------X-M---??BX--?--?------B-----??B----X--Mo------o--?--B--B-BM-oM----M--?-?B---?-??M--M----M--?-X--?-------o----B--?--X--BX------M-X-X-B--X---MM-B--BX--?-M--?X--oo-o----o-o-----o--?-f
--oB----X---BB-B--?-To-X?M----?X--B------o-X-----o-----------M--X-X---XM--?---o??-XB---X-----?X-------M-MB-B--XX--Xo-----------------X?--X-B-?-X---M-B-----o-----B--E--X--X--XoX-X-?---MB-X-----MM?E?--f
-----oXMB---o---oM--|X--o-oBBB--X-B?X--???-MXoBo----?M--XM---o-XBBB?--?o-?----------Bo--?Mo?B--?-?X------o-----o---??XB?M----B---X?MX---?-?-----BX-o-o---B--------XBMM-X-MB---------?---oX----?X---B---f
-?-X?X----?-MM-BX---X?---------X?--o-M--o----?oM---?o----o-X?X-M-----B-----XM-X-B----?--o-B---X-----?X-BM--X--?---?o-----o?MXo-B-X-----ToM----XX----BB??MoE---?M?---o-B----X----M?-o-M--X------X?-X-X-Bf
----------oX---oXX--X--E--o-------X---X--X---o-o-XX-o-------o-----T-X-X--------o-o----X-----X--------------o----E------?-X-------------X-oX--X---------o-X?-----------o------X--o--T-----o--XXoX--X----f
m---X--o-------X-X----XB------X---------X----M-------------X-X----|--------------X-X--X------M------------XX----X-------------o------X---o----X----?X??o-X--o---o-X-----o----------|---------X---------X
XXX--X-XXX-XX--XXXXXX--X--XXXXX--XXXXX--XXXXXXX--XX-XXX--XXX--X-XXX--XX-XXXXX--X-XXX-XX--XX--XXXXXXXXXX-XXXXXXXXXX-X--X--X-X-XXXX-X-XXX-X-XXXX-XXX-XX-XXXXXX--X-XX-XXX-XX-XXXXXXXXXX--XX-XXXX-XXX-XX-X-X
