|------------------------------------------------------------------------------------------------------------------------------------------------------------------------------------------------------o
X------------------------------------------------------------------------------------------------------------------------------------------------------------------------------------------------------X
?------------------------------------------------------------------------------------------------------------------------------------------------------------------------------------------------------B
E------------------------------------------------------------------------------------------------------------------------------------------------------------------------------------------------------M
B------------------------------------------------------------------------------------------------------------------------------------------------------------------------------------------------------T
X-B-B--B-Mo-o?-MMBM--M-oX-B-Xo-oo-EBoBE?---Bo?--M?--M?B?------o?B-B-M?BE-oX-??M?ooooBoo-?EoM-?-?BBo-?Mo-XoBM-o|?--XXX-o--?--ooMM??oo-?oX--XMXBo-o--?B-E-Boo-XoooBoX--Mo?B?-?-|-MoX-M-BM?MoB?-???B---oB-E
TB-o-?M---??M-------o--X-o--XM-XXXX-M?M-o-X-X-?---------o-?XooX----M-BM?MoXB----E-Bo---XMMX---M---Xo---oBB--ooX-M?-M---MB-MoXB----M---o---X-B-?-o??--??o-Xo-X-Mo---M--B---M-MXB-BM--o----o--o-----o|?-o-
---X----oM--------X?M?oB-MBMM---XBX---MEoo--oX-B--ooXXo-X|--??------oB??-oo-B-?-X----o-----BM-----o?M?B---o-------X-o-o--M-MM-?XM---???-X-?o---?X----BEMo--oB---B------MXo---?-o--M-X---M?---o-o--XX-o-v
|--oB-----MMX-X-XXX---o-------B?--oM--BM-X?BBoo--XMMM-BoBX-X--Moo--EB---?M-M-?--?-?--Xo--o----o-oo-------?M--ooMB--o--o-B-X-------------?--?-?--?-o-MM?-?o-B-o----B-oM---?oX---M-X-XB-o----E---X-?XX?M-|
E?oB--o-MB--M-?o?----M--|-X-BX--o----Eoo-?---B-ooB-----o-oooX--M-BB?--B---o-B-------oB?X-ooBX-X-MX-o-M-MX---o?X----o-MBB-E--Bo--?o-?M-Eo-|o-?-XX---BBE?---B-B---MX-oo--oo-X?--M-EX-B-?-MBBBX-o?-X--o---M
|-M----M-----B-M--?-?-XoX-----XoB--B?B?-B-??--MoM-XM-Mo---XXM-o-B--XooMBM--X--XM-MXMo--B-o?--Xo---?---M-Xo--o-----o-o----?oB-?-------X??-X-o-oX??BBX?M---X---?X?----?XoBX-o-o-X??X--E--B-M?Bo--o--EoB-B?
-?--BB--M-?-M-M--M----ooB-MXooMB--?--E-M----?---------Bo---M-MM-----?X---o?BXX?o?---o-X?MX-?-?XB----B--BM??oB--BooooX-M-X-?----o-BBM??----Mo-B---o--?-X---X-?-B-o-BM-XB-o-M-XMX----??-o-B---XMMMX??----M
M--M------------------X-----X---o---X?B-BoX--BM--BMBX--XEMB-o--EBo-?-Bo-o--BXB?X-X-XoBo-XBB-T-o-MBoB-|-----B-?--M?-B-M-XX-----?Xo-ooE-?o-o--o?M??XM-----o-XE---XM?--o---M--M-XoBo-M-?oM---MME---oXoMM--E
|---BX-B-oo-?X-?--?-------oB-o----oo-----?oX---oB---?XBBB--?oM?B-??-?----o-B--?--oBB--XE----|??---o-oXo---?---------B-?oB-oo---oB-XBB--X--BBXB-B-o----BooMXBX---BMXBX-Bo----?---X--o--XBB-XBMB-??o?---B|
m--X--?-o??--oo-oo--o-oBB---o--ooX-?ooX?B-BoXXoo--|X--o-??o-B---B----X--B?-----BMB--oo-B?X-BX---??X---B-B?--?-ooo?X?---T-o??-?-X-o--B|-Bo-----o-oXMMBX-oXB-BB||XBoo-o?-oooB?-oMX?-?-Xo-Bo-X-|------X-?-o
XXXXXX--X--X-XXXXXXXXXX--XX-XXXXXXX-XXX--X-XXXXXXXXXXXXX--XX-XXX-XXXXXXX--XX-XXXX-XXXXXX-XX-X-XX--XXXX-X--XX-XXXX-X-XX-XXX--X-XX-XXX-XX-XXXXXXXXXXXXXXXXX-X--XXX-XX-X-XXXX---XXX-X-XXXX-XXXXX-XXXXXX--XX
