o-------------------------------------------------------------------------------------------------------------------------------------------------------------------------------------------------------
?------------------------------------------------------------------------------------------------------------------------------------------------------------------------------------------------------|
|------------------------------------------------------------------------------------------------------------------------------------------------------------------------------------------------------T
?------------------------------------------------------------------------------------------------------------------------------------------------------------------------------------------------------|
X------------------------------------------------------------------------------------------------------------------------------------------------------------------------------------------------------o
E-o?E?B--Bo?-X--X?--E-?BBoBEM--M-------?-B?--?o--BoMo?B-o?B-o-BB?M-BMX-EooM-Bo?----M-ME-MBoX?oBMMoMoM-B--?o-XMo-o-?--oBoMM-X-?BMM?Mo?--Xo-MX-MBB-X-M?oX?M-BB?-?-Xo-oooMXoo---oBBo-EMXB-oMo--oBo------BB?
??-?M---o------o----B-o---XM-o?--oBo?--ooo-o----X-?-?--X-o-?o-----o--Bo?Xo---E-MBB-o?-Bo--oX-?o--M-X-o-BooB??-oEM-----------o-oo-o-B-X?BB--o--o-B-o--MM----ooooo---X-M-MoB?-oMooXXX-X-oo--X?E-BEMM-?---T
?o-MXoo-MB---Moo--EoXB?-oXMM-B---X-?-M--M--?---?oX-B--Bo-------o-MMoo-M?oB-oBB-o--?B--Bo---?--B--BM--M--?-----MX--Mo-EM--Mo-X?-?-oX----o-?-BB--o-Mo-o-o-T-oo?o--X-Xo----M-o-M--?X--oEX?o--?X????--X-BX?v
XM?oMo-?---o?-Xo--?XB-oooM--Mo-o-BB--oB--o--o----X--?-oB-?--oo-Mo-o-?-o-o-X?BMM-o-M?MMo?-?BooM-B--Xo--o-o-X---oo--ooXM-MM-XM----o-oo------?-o-oo---MMBBB|MMMoo--B-M?---?-X-o--M-?-MXBMooX--oB?-M--M----T
Bo---?Mo-o--ooBMooX-oB?-X----o-oo---BX--?MoMXoX?-MoB-?oooo-XMBB-B-oM------?-oo--TE--oX?-?oo-o---o??M-oMXX------XEo?---?o-M-oB-X--MX-?o-BX?----?MXE?o---oX--??--XoX--o-Bo-?--ooo-o--M----o?-Bo-?-XB-o-o?-
?-BB---oM?BoBMo--oMo----E-MB----XMo--o--oo-?--o-B-M----?--?o-o-Bo----oo-o?-o-o-E???-MB--o---X---B---?M--oEB-E???MX-o---?o-M---BMX-M?-BX-o-XoBo--MM---M----B|o-oX---M---E---?-oXo-?BoB?MMo-B-Xo--B-oo-M-|
|Bo----M--o---oXoB-BB?XX?B-X-?-EE-XM-o-o?Bo-B-M----BB?-oo?------o-B?oM---XB?-BE?XX-M---Xo-oo-M?B-----o-?XMMBBo-oo-EB|-o-X---oo------?-o--X?o-Bo---X---X-X--XXB--X-?-?B?M-?--oB??--?E----B---BB?E--M?oooM
---X--Mo-B-M--?o--M---BB-o?-X-?BM-?--B-Xo-o-----B??-----?---?-Eo-B--M--oX---?-XooMMoX--?-??o-----o-XB-----oX-o??--?-X-?-XMo-X?B?B?X--oXo---X---Bo-B--Xo---?M--BE------X---E?o-o----B--XM-----oXM-o-oMX??
o--Eo-----Xoo-------oo-----o--o?----o-E--o-o-o-o----X-o-----BXB?---o-oo--Xo-??XM--o-o---Xo-XX--o-o------oXTXooo-oX-----Xo-Eo-----------oo------o--------o--oXX-M-oXX----oXM-X--o--EXo----o-X-E--ooB-oooE
mBXBXMB-----ooo------B-|oXoXoXo-Xo---BB-------oo-o-o---o-o--Xo-o-oXoX--o---XXo----oX---o--ooXXooo-Xo-o-X-X|XXooo-oX-o--XoM?o-oo--o--oo|o--X--oo---oXoX-o-o-Xo-X-o-ooooo-ooX|----MBB?-|-MM-oBMM?-----o-o|
XXXXXXXXXXXXXXXXXXXXXXXXXXXXXXXXXXXXXXXXXXXXXXXXXXXXXXXXXXXXXXXXXXXXXXXXXXXXXXXXXXXXXXXXXXXXXXXXXXXXXXXXXXXXXXXXXXXXXXXXXXXXXXXXXXXXXXXXXXXXXXXXXXXXXXXXXXXXXXXXXXXXXXXXXXXXXXXXXXXXXXXXXXXXXXXXXXXXXXXX
