?------------------------------------------------------------------------------------------------------------------------------------------------------------------------------------------------------T
X------------------------------------------------------------------------------------------------------------------------------------------------------------------------------------------------------E
X-------------------------------------------------------------------------------------------------------------------------------------------------------------------------------------------------------
X------------------------------------------------------------------------------------------------------------------------------------------------------------------------------------------------------B
o------------------------------------------------------------------------------------------------------------------------------------------------------------------------------------------------------E
T|-oMBo??-MB-XXB-?M----oo-M--Eoo?MBo-o--MM?oo--oXX-oB-oXo?o--BXMo-oo-XoX-BX-o-?-Boo-X?M?XX----E?B?-oX-oBBEMXMooo?B-BMX-o---oXo---o-Boo-MMooMX?o?oMB--ooXM?oEM?EM--oX-XXXM?-BBME-XM?M-B-??oXX-oBM-MB-X--M
oX-o--B--M--X-?-B---o?oM-M-XoB?-----o-X?---X-?XMo??M-oB---X-o-M-MoBB|o-o--o-ME---?ToM----oEMoMX---oX?MoX??---BMo--B---XX|o-o-?BoMX--o-E--M--M------?-BM--MMX--M-BX--?-oo----MMXMo---------B-oE--o----EBB
--Mo-------X?B---B?MB-B-?--X---M-X-oM-o-o|-oX-B-?---oB-ooo-Bo-------XMooE-XMB?B?--|M-?XB-??----|--BM----X-?-?--B------MMXB-M---o-BX?BBX------B---X------MBX--BM--ooM-?--o-o--XB-----X-BBM--BBXBoMoX?TM-v
MB-X---??M----o-BMM--o-B-MMB----M--B---XXXXB-B----X?o-BB?B--XoX-X------MB--X-B--MMX-X-o-M--XMMMX-?------XB-?--B-X--Xo---?---Bo-o--o----?--XM-----oo-?X-M---XX---??--B--oB-o----M??XBM?----XXoX-B-oo-|--?
----oMB---|--oX-----Bo-------ooX-----o--MoM-M-o-o-M-MX----M--o--oMooXB---ME---o----oo-----T--------BE-o-M-M--------XBB-o--Mo-B-X--oX------E-?oB?M-?o--o---ooM-----o?--M---B-X-o---E---MX--M-ooB-M?-oX--o
-M-B----o-X--MB--MEX-MEB--B--MXB-|--?-BB-o----X-X--?-o-----XM?--X-?Mo?M?MXMo--?B--M--XoX--XM---Eo--XB?XB-B-B-B--oX-B--X?--------M--B--oo-o?--M-----E--B-oMXM-oEB--X--?-oBo-B-E??MX?-BX-B-----M-----M-B-T
X---B-M-?B-----XE-XB?M?--X-B?-X--Xoo-o---?-MEB-?-BX--B----B---o-Xo--EMo----MM----M-?--M-?BX-oBBMX-?o?-X---o-X-o-ME--X---M-MXB?o---o--X?-M--BX---XoBBXo----?-M-X--B-?--o-XM-M?B---BXX--?--oX-?----M--o-B-
?-?----B---E-o??XXB---o--?B--o-?---E-o-B--BMB-------o-?BM---?----?-XM-X-ooX--E-M--T-E--X---??------B-----oo--o-M-M?Bo-X--B----oB-??M---o-EB-M|-X--|-oB-oX--B-B-?--o-M-?-X-?-o-?---?TM----MBB-X-o--M-Eo-o
|--??-o--M?BM?X-o--B-?-?---o--o--MMB--B-Bo--X---oX-o---------BoBB--oo-?-XX-B-X----X-X--B--------o-o-?BX-?o-B--o-oo--X---X-Xo--B---------XB-X-Xo-o-XB--oB-BB-B-?-oBB----oo----X-B---|-o-o------oEBoMBBMoo
m----o--?-oX?-B?ooB-X---Bo-B?X--X-Xo-o----?B?-?-XB-X---B-|BXX-o---XB-o--oB---?o?-B??-o----oo----o-?X--Bo--------?---oo-o-B-??--BT---?--o-o-ooXo-B?-----------B-X---o--X?o??X-XX-oX-XX?B-B?o-oM?X-B-BXo?M
XXXX-XXX-XXX-X--XX-XX-X--XX--XXXXXXXXXXX-X---X-XX-XXXXX-XX-XXXXXX-X-XXXXX-XXX-X-X---XXXXXXXXXXXXXX-X---XXXXXXXXX-XX-XXXXX-X--XX-XXXX-XXXXXXXXXXX--XXXXXXXXXXX-XXX-XXXXX-X--XX-XXXXXXX--X--XXXXXXX-X-XX-X
