o-------------------------------------------------------------------------------------------------------------------------------------------------------------------------------------------------------
?------------------------------------------------------------------------------------------------------------------------------------------------------------------------------------------------------|
|------------------------------------------------------------------------------------------------------------------------------------------------------------------------------------------------------T
?------------------------------------------------------------------------------------------------------------------------------------------------------------------------------------------------------|
X------------------------------------------------------------------------------------------------------------------------------------------------------------------------------------------------------o
E-o?E?B--Bo?-X--X?----?BBoB-ME-M-------?-B?--?o--BoMo?B-o?B-o-BB?M-BMX--ooM-Bo?----M-ME-MB-X?oBMMoMoM-Bo-?o-XMo-oo?--oB-MM-X-?BMM?Mo?--Xo-MX-MBB-X-M?oX?M-BB?-?-X--o-oMXoo-E-oBBo--MXB-oM---oBo-----oBB?
??-X?---o--o---o--o-o--------M?o-oBo?---o-oo----X-?-?--X-o-?o-------oBo-Xoo--E-MBB--?-Boo-oX-?---M-X-o-Bo-B??-o-ME--------E-o---o-oB-X?BB--o--o-B-oooMMo-----ooo---X-M-MoB??oM--Xo--X-----X?--BEMM-?-ooT
?--MXoo-MB-o-Moo---oXB?--XMM-B---Xo?-M--M-o?-o-?oX-Bo-Bo-o-----o-MM---M?oB-X?Mo-oo?B-TBo---?--B---o--M-o?-o---M-MXMo|EM--MB-X?-?--X------?oBB-E--Mo-o---T--o?---X-Xo----M-o-M--?X--o-X?o--Bo-o-MooXoBX?v
XM?-Mo-?o---?-Xo---XB--ooMo-M----BBo--B--o--oo---X--?--B-?--oo-Mooo-?o--o-X?BMM-oo-X?|-?-?B-oM-B-oXo-oo-o-X----MXB-?XB-MM-XM-o----oo-----o?ooXMoo--MMBBB|MMMoo--B-M?---?-X-o--M-?oMXoM-oX--oB?-M--M---oT
B----?M--o---oBMooo--M--X-------o---BXo-?M--X-X?-MoB-?--o-oXMBBoBooM------?--o--T-o-oX?-?--oo---o??M-oMXXE-----X-o?---?--M-oB-X--MX-?ooBX?--o-?MXE?-o---Xoo-B--X-X--o-B-E?--ooo----M----o?-B--?-XBoo-o?-
?-BB-o-oM?BoBM---oMo-------o----XMo--o-o---?--o-B-M---X?--?oo--Bo----o--o---oo-E|o?-MB--o--EX-o-B---?M--oMB-E?-?-B-o---?o-M---BMX-M?oBX-ooXoBo---B---M----BM?-oXo--M--X??-o?-oXo-MXoB?MMo-B-X-BBB-oo-Mo|
|B-o---M----o-oXoBoBB?-ooXoX-?---oXM-o-o?Bo-B-M----BB?--o?------o-B-oM---XB?oB-?XX-Mo--X-B?B?M-B-ooo---?X-oM?o--o-EB|-o-Xo-ooo----o-?-o--X?o-Bo---X---X-X--XXB--X-?o?B-EE?--oB??--?--oo-B-oEB-X---M?--oM
-o-X--M--B-M--?o--M---BB--?EX-o-o-?--B-Xo-------B??o----?-o-?-E--B--M--oX-oo?--o-MM-X--?-??o-------XB----ooX-o??-M?-X-?-XM--X?B?B?o---X----X---Bo-B--X-E--?M--B----oooBBB--?o-o-------oX-MXB-oMooo--MX??
---Eo-----Xoo-o----o-------B--o-o-o-o-E---MX?B-oo-ooX--o----o-Xo-----o---X---ooo----o--oX--XX--o--------oXTXo----X-----X-o-o----------ooo---oE-o-E-o---Bo-o-XX-o-oXX--o--Xo-X-----EX----MX-X-Eo-oo-ooo-E
m--XMXXB--o-oo---o--B?o|oXoX-Xo-Xo--ooM----o-o-o-o-o--------Xo---oXoX------XX-----oXo--o--ooXXooo-Xo-o-X-X|XX-o--oX-o-oXoo-oMX---oo--o-o--Xo-?o--MoXoXo-|o-Xo-X-o--o-oo-ooX|-o---MXo-|-M?-o--X------o--|
XXXXXXXXXXXXXXXXXXXXXXXXXXXXXXXXXXXXXXXXXXXXXXXXXXXXXXXXXXXXXXXXXXXXXXXXXXXXXXXXXXXXXXXXXXXXXXXXXXXXXXXXXXXXXXXXXXXXXXXXXXXXXXXXXXXXXXXXXXXXXXXXXXXXXXXXXXXXXXXXXXXXXXXXXXXXXXXXXXXXXXXXXXXXXXXXXXXXXXXX
