|------------------------------------------------------------------------------------------------------------------------------------------------------------------------------------------------------|
-------------------------------------------------------------------------------------------------------------------------------------------------------------------------------------------------------B
M------------------------------------------------------------------------------------------------------------------------------------------------------------------------------------------------------X
E------------------------------------------------------------------------------------------------------------------------------------------------------------------------------------------------------o
o------------------------------------------------------------------------------------------------------------------------------------------------------------------------------------------------------M
B-o--X----oo---ooX----o--o-B---o----oo-oB------o------Boo-o-X--oEBB--o--oo----oB----B-----ooo------o-------oo---Moo------oo?M--oo-M-oE----Bo--o-X---ooooo-??------XM---o----?-o---B--o-o-o---?o-------oE
o--X------o------o---o--o-oo--oo?-o---B--E---ooooo---ooMooo----XX----o----oo--o------B--E--o-o-o-o-Bo-----o---B--o?o---oo-o--------oM----o--o--o-?------oo-----o--oooo-----o--oo-o-o----oo-----ooo--o--X
--X?-X----ooo?o-o-oo-------o-----o-oo--B?X-----o--o--M------o--o--o-X-B------oX-o-----?BMo--o-?-o--o-o---oo---oo-o--o--Xo-oo-?---oo---o------M----------?------ooo---o--B----X--XM--o---o-X----BX-----ov
Eo--------o------E------o-o-o-o-------B--o-------B----o?-o-X-o----B-----o-o--B--oo--o----B--oo--o---o--B-B-o--MXB----?oo-oo---o-----o-o----o--o-oo-----------?-o-----MoX------------o----Eo--o---------B
B--oo-----oo---B-M------oo---Mo----oo-----o-o---o---o-----o--o-oX--X-o--o------o--oo---o--oooo----o----oo-o---o---o---X--o---------o-o--o-------o-------o---oo-XB-o---B--?Boo-o---oo---BX?Boo---ooX----T
T-----o--o?---o---o----oo------o-M-BM----o---B---------o-oMo--o-?-?--B-o-o?-oMB----o-o----Xo-oo-o-o?B?o---?---oB----M-X---oo----------------ooX--o-o---o-oMX-M--o-o---o-------o----o---o----o---?--Mo-oX
E-o--B--B-----?--ooo------o-------o--oo--o----o-o--o-o-----o-------X-----o-?-o-oo---B-----o--Xo-?-----------o------o-oo-oo-o-----o------o--ooo-o-o--?o--o-------o---o--o-----------o---ooo-o------o----T
B---o---o----o--o-oX---X-Boo----MoX------o--oo------------X--o-oo----X-Mo------o?--o-----o----M-o--oo---M-----o---o----------o---oo-oM---B-Xo---o----oB--o---o?oo-------o-o--o-----?-------X---MX-oM---M
-o---o--------o----ooo--oo-o-----o--------o------o---o-----------------o-o--oo------oo---o-o---------------o------------------o-o--Xo-----oo-o-----ooo-oo--------o-----ooo---------------oo-----o------B
m--oo-oo-o-o-o--o--o--oo--o------o------o-o--oo--o----oo-o--o-X--------o-X--o-o---o----------ooo-------o-o---o------oo-oX---ooo-oo-o-o--?o----oo-o---oooX-o-o-ooo--oo--ooo--o-----o---------Xo----oo---?
XXXXXXXXXXXXXXXXXXXXXXXXXXXXXXXXXXXXXXXXXXXXXXXXXXXXXXXXXXXXXXXXXXXXXXXXXXXXXXXXXXXXXXXXXXXXXXXXXXXXXXXXXXXXXXXXXXXXXXXXXXXXXXXXXXXXXXXXXXXXXXXXXXXXXXXXXXXXXXXXXXXXXXXXXXXXXXXXXXXXXXXXXXXXXXXXXXXXXXXX
