T-------------------------------------------------------------------------------------------------------------------------------------------------------------------------------------------------------
X------------------------------------------------------------------------------------------------------------------------------------------------------------------------------------------------------?
M------------------------------------------------------------------------------------------------------------------------------------------------------------------------------------------------------?
X------------------------------------------------------------------------------------------------------------------------------------------------------------------------------------------------------|
|------------------------------------------------------------------------------------------------------------------------------------------------------------------------------------------------------B
XBo-?-?E-M-BBE-M?M-BMXB-B---?Mo--o-?o?MB?--oBMXEoXo-MoB?o?XB-B--E--EM-X?-o-B?B-?T-XBB-BM-EoX-M-XXoM?-?o-XMoBB-o?M-XBEooM-?-MBoB?Bo-XB-----?o?--M-MEBoMoBo?BXoo-X-M--BXo-Xo?B???-X----?o-?-B?B-M?Mo--MM-T
---o-?BBB---BBo---?--E-B--M?--?X--B-M----o-X--M?---M-o--M-M-o-XXBMMB-----M------|o---B--BBXB--oM?o--T--------M---oo?B-?---o--X---X?o--o?E--B--o-B?M-?-o-?---M??-M----XB--X-----BBB--M-?B-o-------?-M--?T
M-oB---X--Xo--M-Xo--MXo------o-oo--X-o--BX--B-B?o?o--M---o-oB-----MBoMMB----BB--XMXM?-oMB---?BB-----|?o?o-o-?-XoM-BB?---o-BBE-o-----oBo-M-----XB--o--B-----o---o--MB----XXo-Eo----M?----X?M--oo---M-M--v
M------M--oMMMMBMM-o?BX-BoXB--o-M---XB-BoX-E------E---BB-?B----M-o--o---BBoX--?-o-X--??----o-----o--X-oBXB?B--BX-oMo-?-BooX?XM?-XB-oo-M-M-X-oMo-M-oBX-?B-BXM?--Xo----o--MoMXBB---X--BoE----?-MoX-?-M-Xo|
M-X-oo---oB---Eo---?-----oo-M-BX-E-?--M-MM-X-Bo-MMM-?---B---o-o-?M--o--X--Xo-B----XE-----Mo?-??B-oB-E--o-----o---?-X-----o-BMo-Bo------o-?--E----Eo-oM----B----o---M-XBM-?-o---MM---XMM--Xo-o-oX------E|
B??o?---?M-EXMM?--E--o-o-??--o-???M-M--B---o--Bo--?--B-X-?--B-M---o-X?-M---Mo--X--MXoB-B--o-X---XXMBBBXoX-X--XoBo-XMMMBoEB?--Bo----??-BXB--?X-M?MB-oM---MoBBMXMM----B-----oXBM----EBo----MB----M--oX--XT
M--M-M---B??M-MoM?MBMMXX-----M---B--------?-M--MB---T--BX----o-Bo-B?B-o-M-M-o--?Mo----B----X?B--E-E--B-XX?-o-----?o---?M?--o--?o-oo----o--E-----X?B---XM-M---M--o-?---??o-M------oX-?-MB?--oX-o--X?B?-oX
Xo----?B?--M-M-M-oM---B?BXBo--o?----B-?o---E-----?BX|MX--Bo-BB--MB-B--M--?--Xoo----oo-----oB---MM-?-----B-BB-?EXX-B--XX-X--XEM-BMBXM-?-?X-?--o--o--M--o---oBB-MXE----o--X--B-----?M--M----M--BXXXX---o?T
TB--------X-X---X--o-------BB-?--o---B-o-BXM?---o--?X-X-B--X--oB--o-?---B--XEXo---oBBX-E--B---X-XB?MXo-?----MBXB?--?-X?X--?M?-------?-----|?-?X?X----o-EX-X---BB?----?-Bo----Xo-o--?--BoX--oB-XX-X---T-M
m-oBo-o?X-XX-o?Xo?-ooX--B-o--o--oBoBo--X-XXBoo--BoB-X-o----B-oo-oo---o-?---MM-?--XB---oMoo-X|o-o-?-oXo---|o?|MM--X?-BB--X-B-B--o--o--?o?oBX---B-?Bo--XB?-?MB--ooo-X-B-o-B-B?o?-oX??-BB-oo--o-XoX-oooo|-M
X-X-XXX-XXXXXX-XX-XXXXXX-XXXXXXXX-X-XXXXXXX-XXXX-X--XXXXX-X-XXXXXXXXXXX--XXXXX-XXX-X-XXXXXXXXXXXX-XXXXX-XXX-X-XXXX-X---XXX-X-XXXXXX-X-X-X-XXXX----X-XXXXXXXX-XXXXXXX--XX-X--X-XXX--X--XXXXXXXXXXXXXXXXXX
