--------------------------------------------------------------------------------------------------------------------------------------------------------------------------------------------------------
--------------------------------------------------------------------------------------------------------------------------------------------------------------------------------------------------------
--------------------------------------------------------------------------------------------------------------------------------------------------------------------------------------------------------
--------------------------------------------------------------------------------------------------------------------------------------------------------------------------------------------------------
--------------------------------------------------------------------------------------------------------------------------------------------------------------------------------------------------------
-XXM-?-BM-B?-M---BX?---XX----B--?-B-----?-o?---MME-M--M-?--MX?---MM-?M??-M--?-M-B--M?---?o?-XX-----?-o-MM------X-o-----B--o-MB--MBX-?-M?---?XM--XX---BX-?-BB-EM--M?--XEXMXo-M--X-?X--TM-??-Bo-B?B?M?----
----?-----oo-o-?----??-?-?BM?-M----M-M?M-??o---?XB?--?-B-BX----?-----oo-?--------------M-?---B--XB--?XB----?-BXX-Mo-M-B--M?M-oo-----o-ooX-M-E-Bo?----oM--B--B?-X-o-X-oM--XX--M--o-M--|-?----X---------?-
-M---oMX-Xo---X-o-MX-------o-?----B--------MM--XB-----M---MX------X-X---o-----TB----B-M---------B-?----?--B---?--------MB-o--??M--MB?M-M----B--B---XXB-X--M--?-XX-o-X??X-o----?BXM---XXoXoXB-B-B??--B--v
------oB---X-?-M--o-M--EX--M--?XB---?--?-----XM-oXMM-B-------XBoX-M--XX-----B-|-XM--o?-B--BM?Bo----X?-X-M?--B---M-X-----o-------?o---o?-E--o-Bo----?-----o-M-----MMB-o--?-XM----M--X----------?---B----f
--X--M--o-XE?----M--o-MBM------o-o-X----X-?M---?--o--o-M---M-M-?-M-B-?---M-X--X---M--o---Moo--BBX-oM--?M-----X-Xo-?---B?---------B-X--oB-X-X--XX-BX-?--M-M--?--X-----o----?-B-?---B-o-???-o?-------X-X-f
--X------X-B--?---XE-----?B--MXM?B-M--X----oBX--BX--B------o----?oB---?-?-BB-XoX-M--??--?--M-oo-X-BoB-----B--?--B-o?---o-----B-M---MX----?-EBoo-o-B---X-X--------B---BoM--?--?---M-MX--------BX-?--X--?f
-?----o?M----Bo-?-BXX-----o-BoXo--?-MB-?----o-X-o?-BoXB---M-?XMo----X-o-----??XB?oXX--------??----o---M------oX--------XB?-------Mo--oBM-BXB--?MM--XXM--o--Bo--?--------M?oM--Xo?---M--XoB-o?-?X-B-XBM-f
-o-E-MB--X--B-X--?oX-B-------E?oo----oM-XB-?-?M------?o-X------B-?-?--------oo--o--?-o------o--BMM-M-X---ME-?B?XB--?-XBB----MM-BM--X------E------------BX?--B---B-?---B---X-M-??oX-----?---B----B--M--?f
--XBo----------X--------X-o-?B-----o------ooX--X-----o---------o------X----X--o---XoX--X--o--o--o-----E--?X-------oo--oo------Eo---------X?----X---X---o----------o---------------------T--------------f
m---------o-o-XT----o--XX-X-----------XX--------X----------o----------------o---X----------X--o--X----XX--XMM?B----------X----XX-X-------XX-X----XXo-------------X-X-o----------X---X---|-------X------X
X-X-X--X-XXXXXXXX--XXXXX--X-X-XX-XX--XXXXXX-XXXX-X-XXXXXXX-XXX-XXXXX-X-XXX-X-XXXX-XXXXXXXXXXXXXXX--XXXXX--XXXX-XXXXX-XX-X-XX-X--XXX-XXXXX-X-XXXXX--XXX--XX--X-X-X--XX-X-XXXXX-XXXXXXX-XXX-X-XXXXXXX--XXX
