?------------------------------------------------------------------------------------------------------------------------------------------------------------------------------------------------------T
X------------------------------------------------------------------------------------------------------------------------------------------------------------------------------------------------------E
X-------------------------------------------------------------------------------------------------------------------------------------------------------------------------------------------------------
X------------------------------------------------------------------------------------------------------------------------------------------------------------------------------------------------------B
o------------------------------------------------------------------------------------------------------------------------------------------------------------------------------------------------------E
T|-oMBo??-MB-XXB-?M----oo-M--Eoo?MBo-oo-MM?oo--oXX-oB-oXo?o--BXMo--oEX-X-BXEo-?-Boo-X?M?XXE---E?B?E-XooBB-MXMooo?B-BMX-o---oXo---o-Bo-EMMooMX?o?-MB--ooXM?o-M?EM--oX-XXXM?-BBM--XM?M-B-??oXX-oBM-MB-XE-M
oX-o--B--M--X-?-B---o?oM-M-MXMM-----o-X?---X-?XMo??M-oB---X-o-M-MoBBXo----oBM----?ToM----oBMoMM--XBX?Mo------BMo--B---XX|ooo-?BoMX|-o-M--Mo-M------?-BM---X-MMB-BX--?-oo------o-o-----o---B-o---o----?BB
--Mo-E-----X?B---o-MB-B-?--X-E-M-X-oM-o-o|-oX-B-?---oB-ooo-Bo-------XMooE-Xo--o?--|M-?XBo?----o|--BM----X-?-?--B------MMXB-M-----BX?BB-------B---X------MBX--BM--o-M-?--o-o--XB-----X-BBME-oXoXoMoX?TE-v
MB-BBM???M----o-BMM----B-MMBMX--M--B---XXXXB-B----X?o-BB?B--XoXoX------??--X-B--MMX-X-o-M--XMMMX-?--o---XB-?--B-X--Xo---?---Bo-o--o----?--XM----ooo-?X-M--EXX---??--B-o-B-o----M??XBM?-M?XXXoX-B-ooXBM-?
----oMB---|--oX-----Bo-------ooX-----o--M-M-M-T-o-M-MX----M-----oMooXBE--ME---o----oo-----T--------BE-o-M-M-T-----EXBB-o--Mo-B-X--oX--------?oB?M-?o--o-BB?XM-----o?--M---B-X-o---E---MX--M--oB-M?-oX--o
-M-B------X--MB--M-X-MEB--B--MXB----?-BB-o----X-X--?-o------M?-oX-?Mo-X---Mo--?B--M-oXoX--XM----o---??XB-B-B|B--oXMB--X?---o----M--B--oo-o---M-----E--B-oMXM-oEB--X--?-?Xo-B-E??Mo?-BX-B---E-M-----M-B-T
X---B-M-?BE----X---BB-B--X-B?-X--Xoo-o---?-M-B-?-BX--B----B---o-Xo---Mo----MM----M-?--M-??X-oB--?-?o?-X-E-o-X-o-ME--X-o-M-MXB?o---o--X?-ME-BX---XoMXXo----?-X?B--B-?--o-XM---X---BXX--?--oX??----M--o-B-
?-?----B??MM-o---MB---o--?B--o-?-----o-B--B-----------?BM---?-E--?--E-XoooX---oM-XB-E--X---??------B--BBXoo--oo???XB--X--B-E--oB-??M---oM?B-M|-X--|-oB-oX--B-B-?--o-M-?-X-?o--?---?TM----MBB-X----M--o-o
|--??-o--B---?X-o--B-?-?---o--o---oo--B-Bo--X---oX-o---------BMBB--BX-?-XX-B-----oXBX--B--------o-o-?BX-?ooB----oo--X---X?MX?-B--------XB?-X-X----XB--oB-BB-B-?-oBB?----o----X-B---|---o--?MBBoEBo-o-Xoo
m-o--ooo?-oX?-B?ooB-X---Bo-B?X--X-Xo-o---o?B?-?-XB-X---B-|BXX-o---XB-o--oB--o?o?-B??oo----o-------?X--Bo--------?---oo-o-B-??o-BTo--?MB--M-ooXo-B?----o------B-X---o--X?o??X-B---X-XX?B-B?o-oT-M-B-B-o?M
XXXX-XXX-XXX-X--XX-XX-X--XX--XXXXXXXXXXX-X---X-XX-XXXXX-XX-XXXXXX-X-XXXXX-XXX-X-X---XXXXXXXXXXXXXX-X---XXXXXXXXX-XX-XXXXX-X--XX-XXXX-XXXXXXXXXXX--XXXXXXXXXXX-XXX-XXXXX-X--XX-XXXXXXX--X--XXXXXXX-X-XX-X
