o-------------------------------------------------------------------------------------------------------------------------------------------------------------------------------------------------------
?------------------------------------------------------------------------------------------------------------------------------------------------------------------------------------------------------|
|------------------------------------------------------------------------------------------------------------------------------------------------------------------------------------------------------T
?------------------------------------------------------------------------------------------------------------------------------------------------------------------------------------------------------|
X------------------------------------------------------------------------------------------------------------------------------------------------------------------------------------------------------o
E-o?-?B--Bo?-X--X?----?BBoB-M--M-------?-B?--?o--BoMo?B-o?B-o-BB?M-BMX-EooM-Bo?----M-M--MB-X?oBMMoMoM-Bo-?o-XMo-oo?--oB-MMEX-?BMM?Mo?--Xo-MX-MBB-X-M?oX?MoBB?E?-X--o-oMX-o-E-oBBo-EMXB-oM---oBo------BB?
??----o-o--o---o----o--------o?--oBo?---o--o-o--X-?o?--X---?o-o----o-Bo?Xo---E-MBB--?oooo-oX-?--oMoX-o-Bo-B??-o-ME-------XB-o------B-X?BB--o----B-o--MM-o-o--?-o---X-M-MoBBBoM--XoX-Xo----X?--BEMM-?--oT
?--MXoo-MB---Moo---oXB?--XMM-Bo-EX-?-M--M-o?---?oXoB--Bo-------o-MM-ooM?oB-BMX-o--?BoMBo---?--B---o--MEo?---o-M-BMMo-EM--M--X?-?--X------?-BB-E-oMo-o---T--o?--EX-Xo-o-oM---M--?X--oEX?o--Bo-oXM--X-BX?v
XM?oMo-?---o?-Xo--EXB--ooM--M---MBB--oB--oo-o----X--?--B-?--oo-Moo--?---o-X?BMM-oo--B|-?-?B-oM-B--Xo-o?---X----o---oXB-MM-XM------oo------?o--Bo---MMBBB|MMM-o-MB-M?---?-X-o--Mo?-MX?M--X--oBMMMo-M-o--T
B---o?M--o---oBMoo?EoMB-X-------oo--BX-E?M--X-X?-MoBo?--o--XMBB-B-oM------?o----TE--oX?-?o--o-o-o??MooMXX------X-o?---?--M--B-X-oMX-?o-BX?----?MX-?-----Xo--X-oX-X----B--?--Xo----oM----o?-Bo-?-XB-o-o?-
?-BBBo-oM?BoBM-o-oM?---E-BBBB---XMo--ooX-o-?--o-B-M---M?--?o---Bo----o--o----o-E|X?-MB------X-o-B---?M--o-B-E?-?-B-o--o?o-M---BMX-M?-BXoo-XoBo----oo-M----B|o-oX--oM---E---?-oXo-?o-B?MMooB-X---B-oo-M-|
|Bo-o--M------oXoB-BB?-BoXoX-?--E-XM-o-o?Bo-B-M----BB?--o?--------B-oM---|B?-B-BXXoM---X--ooEM-B---o---?X--?B---o--B|-o-X---ooo-----?oo--X?o-Bo---X--oX-X-oXXB--X-?-?BM?-?-ooB??--?E----B-oEB-o---M?oooM
oooX--Mo-BoMo-?o--M---BB--?EX--E?o?--B-X--------B??o----?-o-?-E--B--M--oX|--?o-o-MM-X--?-???Xo---o-XB----|oXEo??----X-?-XMo-X?B?B?----X----X---Bo-B--Xo---?M--BE----o-XX--E?o-oo---B--BB-E-B-oMo-o-oMX??
----o----oX-o---E-----o--MXBB?BBX-?Moo------Bo-o----X--o---o--Bo--o--o---Xo---oo----o-o-X--XXo-o--o------XTXX--ooX-----XooEo-----oo-o---o--------E-MM---o--oXXMB-oXX-----XB-X------Xo--BBX?X----ooB--o-E
m---XBMo----oo--X---oo-|oXoXoXo-Xo----o---o-o-oo-o-o--------Xo?--oXoX------XX-----oX--oo-oooXXooooX-oo-X-X|XXo---oX-o--XooBo-----oo--o-o-oX--o---MoXoX-ooo-Xo-X-o--o-oo-ooX|--o--X-o-|-oB-oo-o---o-----|
XXXXXXXXXXXXXXXXXXXXXXXXXXXXXXXXXXXXXXXXXXXXXXXXXXXXXXXXXXXXXXXXXXXXXXXXXXXXXXXXXXXXXXXXXXXXXXXXXXXXXXXXXXXXXXXXXXXXXXXXXXXXXXXXXXXXXXXXXXXXXXXXXXXXXXXXXXXXXXXXXXXXXXXXXXXXXXXXXXXXXXXXXXXXXXXXXXXXXXXX
