?------------------------------------------------------------------------------------------------------------------------------------------------------------------------------------------------------X
o------------------------------------------------------------------------------------------------------------------------------------------------------------------------------------------------------M
|------------------------------------------------------------------------------------------------------------------------------------------------------------------------------------------------------|
M------------------------------------------------------------------------------------------------------------------------------------------------------------------------------------------------------|
B------------------------------------------------------------------------------------------------------------------------------------------------------------------------------------------------------?
M----?-?o-?-?BBooM?oo---------BoX-X-BX-oo-oM?MBoXoTo--B--oBXMBM??--o-MM--M-Boo?XXMoMB--B-Mo--B-?oMo--MM--M?--M-XoXX?oo---o-M?-o-?ooM--B-X-B?BX-Xo-oXXB-oX----BooX-MXXoMB-oMoX-B--MoTo-MooBBo-X-?--ooBB-X
|M-Xo-o-X--X---MB--??XMoo--XX?-Mo--B-BXB?XX----ME-|B----XX-X-----o-XX--oX---X--?B----X?-M-BX?-o-X-o-?--o---M--B-----MX-XMX-----?-BM--B-Xo?---ooXX---o-?---o---?M---Mo---M?--X?-oM-M|---??--BMM--XooM--BM
M--BB-o-?M-B-M---Xo--o-oBX--X-o--o-------?M--XM-MXX-BM?--Xoooo--Bo?-?o-----BMo---oM--?-M------M-o-----BMoMX-X--B--B?-oXX-oMEBM-----XX-oX--?--?-M-?---o-oB-M-?---M---o-o?----X----X-X-MM--o----?B-MB--X-v
o??--X-B--B--oX--Eo-o?-X-XoMM?-BMX-Bo-X-B--XM----------Moo-oBXB--M-o-??---?--------oB-o--Xo--?--B-X-Bo--B-B--Bo-?X--oXXM-X?B----X?B-o-XoMB--B-o---X-BoX?---------o-?-MX---Bo?B?o-?-?o---oM-M----o?--o-oE
?---?---oM--oo-B-BMBX-M?XMB---?--?--oMB----X-M--oM-X-----M??-M-M--oM---B-?-X-B?B--X?-o-oBX----o--ooo-------?B--M--XBXMB-X--Bo-?-X-------------ooXM-o----M-BM---X-??-o-o--o-----M--M-oX----X-o-o-M-M?MB-T
M-oB-?oM---MBMo--M------M------M--Bo---M--oo--XXX----Mo---------?-?-MBo-?-?B----ooX--?Xo-M----X-o-Boo----XB---------B---X?--M--o-??-X-oEo-BM??XBX-ooX-MB-----M-B---?B-??-B--o------o?---M?-B---?-B----o|
MXX-o-o-ooB-------o?-BoB---M--M--o-XB-o-o-o--X?M--B---M--o---BX--B----X------B--B?X-o-?o--MXBMo-M?--XoM-Xo-o--?BMoM--X--X-X--X?Xo---BBB?Bo----B--oMXXM--BBoo--X---B-------B?MX-ooX-M-oB---?-o?----?M-o-E
o-oBB---B?--BMo---X-X-?-B----B--o?---?oo--Xo-X---B--X----oo-?---?-----?----M?--?--o?-?-B---B--MM--o-X?-----------M-M---?MBX-----B-Bo--oX-B-------?--o-----?BM--------oBoo------Moo-o-M---M----BXo----?-X
ooo--?Bo--BB--?o-Bo-oX---X----X-?---X-B?--oXX---X-XBX-BB-BBB--o----------B---oB--XX---o-?-T--------oo-o-o----B--?-?-B--------B?B-B-?--BXo--B?--oB-Boo?X-------------To-BoX----o--o--?-??----X------T----
mo?-o--?XB-----oo-B-ooXoo??-o--B-oXXBB--o-X-?-o-BX--B?-------?---Xoo-------?-X-BoXXo?-o--B|X-|--?-o?XBB-?o--o--oXB---?o--oXXo---X---X--Bo-----oX-o-??-XXB-o-o-??o---|X--Xo--o-B-?Xoo-X--X--ooBo-o|o|---E
XX-XXXX-X--XXX-XXX-XXXXXX--XX-X--XXX--XXXXXX-XXX-XXX--XXXXXXX-XXXXXXXXXXXXX-XX--XXXX-XXXX-XX-XXX-XX-X--X-XXXXXXX--XXX-XXXXXXXXX-X-XXXXX-XXXX-XXX-XX--XXX-XXXXX--XXXXXXXXXXXXXX---XXX-X-XXXXXX-XXXXXXXXXX
