?-------------------------------------------------------------------------------------------------------------------------------------------------------------------------------------------------------
?------------------------------------------------------------------------------------------------------------------------------------------------------------------------------------------------------?
X------------------------------------------------------------------------------------------------------------------------------------------------------------------------------------------------------|
X------------------------------------------------------------------------------------------------------------------------------------------------------------------------------------------------------X
E-------------------------------------------------------------------------------------------------------------------------------------------------------------------------------------------------------
E-Xo-XE?oME?MXo-oo-X?EEo-?XoooX-?M?Mo----Xo?-oMo--?XMX-?E?MXEB--EMEMB-E-EMXBBBX--o--E?---BM-EB-B-o-B?-BE?M-XMBMoEXMo?X-XXEXo-XBoE-oX-E-o--X-MEM-BXBM--M-oX?-E-M-X-M-BM-EEXo-oo?XoXEXoo-M?o-oo-EoMMoB-Boo
TMMBM-o?BXMBEo-XB-?-??X?-BoBBB??-o---EEXM-o---MXB--EMX----oBoM-MBB-?o-E-??oo---o-BoB?Mo-?X?----oo---EoB---MEXEEo-EoE-------Mo-oB?X-oM-oXoBMM?XXEoME-E?-o---?oE-Mo-BBE--o?M-o-BM-o?XMEo?-Mo-EX-M--E-Xo--?
-oo-XE---o-?oo?BoXo??E-?-?M-XEMME--B-?X--Bo--BBB?EX?MMBEB?Eo?E?---?MXM-XXXoXEMB------Moo-oo-o-MEE-EoXMX-X??BBEXBM--EM?o---B?MoX-MBB---o?o-?Boo-M?E--BMB?oM-X--EXB??BoMMX-BE-E?-X------X-X-oM??BoEMXMoB-v
?BoBEXMBB-BX-X-oXo----oMM--EoB-oXX---BMB-B-BX-M-???MXXE-EB-??--MEooMEMB-?E-M?X?oo-oM-o--MB-XBM?BoMB---BEEoo-ooBBBoo--BX-o-B-?Bo-o-Eo-X-oo--o?-X-EMB?MM--?-oBEM----XoEX-MEMooB-X-oEBMBB-?-BBX-?X-B-ME-XX-
|ooBEEM-MEMM-?B----M?-oM?--BMXB-?oB-B?o?EoE----XM?-oo-?-E-B--EBEo?o?o-oBBooX-?MXo-MXXXBMooX?-E?-o?M-Moo-oEE?o-o-ooM-o-?BEXX--B-EX-o-o-E?oEoX-EooBB-??-EBB?-M-EoB-Xo---XM-MooB---?MMX-B-BoE?M?-E---?BMB-M
EB--oBBXoX-BM?---EXoM---BB-?XoB-X--X---XE-XEX--M-o-E-B?-E?-BMBEX-XoMX?oEB-Xo-o-ME-oEBXXM-B-MXo?XoX-o--?B--XEXoEXB-o-?Eo--MB?Xo?X----B-XX-XM-E?EXX-o-?M?BX--BMEEo-EMMEo-Mo?EBoBoo-ME-Bo?MoBEXME--?E-EX-B-
?--XoBBXEMo----?--oBoXMoo-?-MBBE-MB??ooBEMBB?-M?XE-E-BBBEEBEE?BM?E----?MME-EMoBMo?MX--?B-B---EoM-BXMXXEMoEEEEoX--ME?Bo-?EEE-X-?--oX-XXo-B-MBXB--B--o-oM-ooEXBE---oXMoooo-BE-EEXXMMMooME-ooMo-EX-BBo-BMXB
MXB-?oBB-oM-EooB-XX-oXXEBE?Xoo-B--Bo-BEX-oMB---o-?-oo--oB-X???o-?M--Bo--BoBoXM--BMXBE?-XEXBMM?o-Xo-ME--XB-?M?X-BoM-M-?oXooM?Mo-M?-oMXE-ooEEMX?B-----Mo?BEE-?-X-?oMB-BBE-?o-XoX-Xo?MXX-EB-MBMEEBXM--BEBEo
X--oEBB-E--?oX?XoX-B-B-XBXBBXooXX---oooXoXXB-o-EBo--oBB?oB?-oXo-XB-?--oo?o--oB-XoX---B?XXX-Boo-o-EEo-o-o--E----oX-Bo?E?---o----XoEBB-B--oEEBBB-Xo??-X?EXBo---EB----o--???---BBX-?EoXoBoo-?Bo?---Bo-Xoo--
m-E?-oEoB?X?BEX-o?oo-o?o?X-Bo--?--?oXB----BX--B?X-oEoo--EE-BoBoB---E-----XE-ooo---XX-XXBB--?---E--B--?X-?-----X-?X??----Bo-o--oB?-X-EX-E--oo-??oEBXX-oB--B-BE--EoXoEX-X-X---?B-?----oX-oo?X-E??B--B?-BoT
XXXXXXXXXXXXXXXXXXXXXXXXXXXXXXXXXXXXXXXXXXXXXXXXXXXXXXXXXXXXXXXXXXXXXXXXXXXXXXXXXXXXXXXXXXXXXXXXXXXXXXXXXXXXXXXXXXXXXXXXXXXXXXXXXXXXXXXXXXXXXXXXXXXXXXXXXXXXXXXXXXXXXXXXXXXXXXXXXXXXXXXXXXXXXXXXXXXXXXXX
