|------------------------------------------------------------------------------------------------------------------------------------------------------------------------------------------------------o
X------------------------------------------------------------------------------------------------------------------------------------------------------------------------------------------------------X
?------------------------------------------------------------------------------------------------------------------------------------------------------------------------------------------------------B
E------------------------------------------------------------------------------------------------------------------------------------------------------------------------------------------------------M
B------------------------------------------------------------------------------------------------------------------------------------------------------------------------------------------------------T
X-B-B--B-Mo-o?-MMBM--M-oXoB-Xo-oo--BoB-?---B-?--M?--M?B?---T--o?B-B-M?B--oX-??M?ooo-Bo--?-oM-?-?BB--?Mo-XoBM-oo?o-XXX-o--?--ooMM??oo-?oX--XMXBooo--?B-E-Boo-XoooBoX--Mo?B?-?o|-MoX-M-BM?MoB?-???B---oB-E
TB-o-?M---??M-E-----o--X-o--XM-X--o-M---oEX-X-?---------o-?|ooX--E-M------XB------Bo---?--X---M---Xo---oBB--ooX-M?-Mo--MB-MoXB----ME------X-B-?--??--?Xo-Xo-X-Mo---M--B---M-MXB-BM--o----o--o----E-|?-o-
---X----oM----X---X?M?oB-MBMM---XBX---ME?X--oX-B--ooXXo-X|-|??---X--oB??-o--B-?------o---E-BM-----o?M?B-BBX-------X-o-o--M-MM-BBBBMBX??oX-?o---?X---oBEMo--oB---B-o----MXo---?-o--MoX---M?---o-MMMMX-o-v
|--oB---o-MMX-X-XXX---o-------B?E-oM--MM-X?BBoo--XMMM-B-BX-X--MoMB-EB---?M-M-?--?-?--Xo--BE---o--o-------?M-EooMB--oE-o-B-X------------o?--?-?--?-o-X-X-?o-B-o----B--M---?o----M-X-XB------Eo--X-?XX?M-|
E?oB--o-MB--M-?o?----MT---X-BX-MX----Eoo-?---B-ooB-----o-oooX--M-MM?--X---o-B-------o??o-o?BX-X-MX-o-M-MX-MMBBX--oMXMBBB-Eo-Bo--?o-?M-Eo-|o-?-XX---BB-?---B-B---MX-oo--oo-X?--M--X-B-?M?BB-M-o?-X--o---M
|-M----M-----B-M--?-?-|-X-----XoBo-BMMB-B-??--M-M-XM-MoE--XXM-o-B--XooMBM--X-----MXMo--B--?--Xo---?---M-Xo--o-------o--?MXXB-?o-------X?-X-o-oX?o-B------X---?X?----?XoBX-o-o--BoB--E--B-M?Bo--o---oB-B?
-?--BB--M-?-M-M--M----|-B-MXooMB--?--E-M----?---------BB---M-MM--E--?X---o?XXEo-?--??B?-o--?-??X----B--BM??oB--BooooX-M??XX----oEBX--M----Mo-B---o-??oX---X-?-B-o-BM-XB-o-M-BoX----BX-o-B---XMMMXT-----M
M--M------------------X-----X---o---BBB-BoX--BME-BMBX--X-MB-o---BX-?-Bo-o--B?BXX-XoXoBo-XBB-T-o-MBoB-|-----B-?E-M?-B-M-XX-----MMX-ooE-?M?o--o--o?XM-----o-X----XM?-BB---M--M-XoBo-M-?oM---MME---oXoMM--E
|M--BX-B-oo-?X-XMM?----o--oB-o----oo-E---?oX-?BMX---?Xo----?XB?--??-?----o-B--?--oBB--X-o---|??o--o-oXo---?--XX-----B-?oB-ooo--oB-BBX--X--BBXB-B------Bo-----------?X-Bo----?---X--o---o--BMXBE??o?---B|
m--X--?-o??--oo?XX--o-oBB---o--ooX-?XXX?B-BoXXoo--|X--o-??o-B---B----X--B?---o-ooB--oo-T?X-BX---??X---B-B?--?-ooo?X?-----o??o?-X-o--B|-Bo-----o--XX--o-oXB-BB||XBoo--?-oooB?-o-o?-?-Xo-BooX-X?X----X-?-o
XXXXXX--X--X-XXXXXXXXXX--XX-XXXXXXX-XXX--X-XXXXXXXXXXXXX--XX-XXX-XXXXXXX--XX-XXXX-XXXXXX-XX-X-XX--XXXX-X--XX-XXXX-X-XX-XXX--X-XX-XXX-XX-XXXXXXXXXXXXXXXXX-X--XXX-XX-X-XXXX---XXX-X-XXXX-XXXXX-XXXXXX--XX
