--------------------------------------------------------------------------------------------------------------------------------------------------------------------------------------------------------
--------------------------------------------M------------------------------M-------------------------------------------------------------------------------------------------o--------------------------
--------M----------------------------------------------------------------------------------------------------M------------------------------------------------------------------------------------------
-----------------------------------------------------------------------------------o--------------------------------------------------------------------------------------------------------------------
--------------------------------------------------------------------------------------------------------------------------------------------------------------------------------------------------------
----?---M-B-X----o--oX--?M?B-M--X-B---BX--X-MB---MB--M---X---?XB-?B-X------?X---?MM?-MB-B------B-X-?-----oB?-?--o--B-?-?-BMM--BX?-----?--o?M-X-o--BX--X----BMMX-B?-?-BX-Mo------X--?-X?-?--?M---?---XBX-
-----X-B-X------MMBMXB------Bo--M---XXo-------Eo-------?BB----Xo?--?----M-Bo-??--------B---BX-B-BX?-X?X--X-----XXBMoB-X-Boo---oXo?-Mo?o-X?--??---Mo---M-----o----o--X--?-X-M-B-B-B---M-M-BM--B----MB-o--
--------??-M??---o----?--BoB-B?--X---M-?-?B--MX----o-X---o--------o--XXX-X---------X?-?o-o---B-----oo---BXMM-XMBX-o--M---B--M---B------BBo-----?o--BX?oo-X----?---MM-X--X?M-?-M-?---M-X-Mo--X-BMM---MX?v
-X-BMoB--o-----?-?B-------?--oo--?BB-o--M---MX---M--?BM----X?BM-B-?--?----BX----B--o-B----?B-o-M--X?BM--o---X----MB---?B-o-M-----MXMX-M--B------B?--M-?B?-X-o--XX-o---o----X---------??Xo?-----M-----Bof
-----Mo-----BMX-M---?-B-o--B---------M-------B-----Mo---MM--o-------Xo-BM----?-----M--M?--o---?--B-M--B?----M-M---o-?-oo?-B-M?-M----o-----------oo--o-o-----?---??--BX--B---o?--B---?--?-o----?--B-X---f
-?X------oB--oX-------------?-----?--o--------B-o----------M---B--?---B---MM-oXM-?---B-o--B-EM--B-ooo-oo-M-?-BoMX--o-M----o---?----------MBX-MoM----?-M-B-M?-M-X---X----o--XM-----X---o---BXXX---oB--X-f
---X----??--o--B---X?XBXBo--oB--------X--X-M?-o--?-MMM-M--o-----B----B------M-X------X---MB?Xo-X--B--MMBX--o--M-?MM?--?M?-------B-----M?--o-B-o----XM----?----?M-----M---X?B--B--o-M-M-o-M----B-----B--f
---M--Mo-o-?----X--?-X-----X--B--X--B--M----------X-----?X-XMM?----X-----------?-M?---M?------B------oo---?----B-----------EX-------M---?B---B---?---B--------o-----X----B---X---o----X----?---X---M--Xf
------o----oT--o--X-------X----------X---------Xo------X------o--------Xo-----------------E-X-------------o--------X--E---B?-----X--o--------oX--o----X--------------X-------XX------oE----------------f
m-----------|X--X----X----------------X--------X------X----XX--------X-X----XX------------B------o------------------X-?---X-----------X------X----X-------X-----------------X---X-o--BB--X-------------X
X--XX-X-X-XXXXXXX--X-XXXXXXXXXXXX-X--XXXXXXXX-XXXXXXX-XXX--XXXXX-oXX-XXX-X--X-XXXXXXXXXX--XXX-XXXXXXXXXX-XXX-XXX-XX--XXXXXX-X--XX--XXXX-XXX-X--X-X-XX-XXXX-XXM-XXX--XX-X-X-XX-XXX-X-XXX-X-XXX-XXX-X--X-X
