--------------------------------------------------------------------------------------------------------------------------------------------------------------------------------------------------------
-----------?------------------------------------------------------------------o----------------------------------------------B-------------------X------------------------------------------------------
-----------------------------------------------------------------------------------------------------------------------------------------B---------------------------------------------??????-----------
-----------------------------------------------------------------------------------------------------??-------------------------------------------------------------------------------------------------
--------------------------------------------------------------------------------------------------------------------------------------------------------------------------------------------------------
-------------?-----o------------------------------------------------------------------------X-----------------------?-----BBBB-------------------------------------------------------------------o------
--------------------------------------------------------BBB-----------------------------------------------------------------------------------------------------------------------o---------X-----------
-----------------------------------------------------------------------------------------X-------------------------------------X-----------------------------------------------------------XX----------v
------------------------------------------------------------------------------------------------------------------------------XX----------------------------------------------------------XXX----------f
-----------------------------------------------------------------------------------------------------------------------------XXX----------?----------------------M----XXXXX--------------XXXX----------f
------T---------------------------------------------------------------------------------------------------------------------XXXX--------------------------------------------------------XXXXX----------f
------|--------------------------------------------------------------------------------------------------------------------XXXXX-----------------------------------------------?-------XXXXXX----------f
------|-------------------------------------------------------------------------------------------------------------------XXXXXX------------T---------------BBBBB---------X-----------XXXXXXX----------f
------|------------------------------------------------------------------------------------------------------------------XXXXXXX------------|----------------------------XX----------XXXXXXXX----------f
m-----|-----------------------------------------------------------------------------------E------------------------E----XXXXXXXX--E---------|---------------------------XXX---------XXXXXXXXX----------X
XXXXXX|XBBBBBBBXXXXXXXXXXXXXXXXXXXXXXXXXXXXXXXXXXXXXXXXXXXXXXXXXXXXXXXXX---------XXXXXXXXXXXXX--XXXXXXXXXXXXXXXXX--X---XXXXXXXXXXXXX-------X|XXXXXXXXXXXXXXXXXXXX------XXXXXXXXXXXXXXXXXXXXXXXXXXXXXXXXX
