?------------------------------------------------------------------------------------------------------------------------------------------------------------------------------------------------------o
-------------------------------------------------------------------------------------------------------------------------------------------------------------------------------------------------------|
o-------------------------------------------------------------------------------------------------------------------------------------------------------------------------------------------------------
-------------------------------------------------------------------------------------------------------------------------------------------------------------------------------------------------------|
T------------------------------------------------------------------------------------------------------------------------------------------------------------------------------------------------------E
M-oMB-----o--oMoB-----B-?oo?M-M-MXoo--B-?---?-B?----M???X?-o-o-oMMXBoooMXXBo?o--o-oB-Mo---oB?o-oBo?Xoooooo--M--BX--B--X-oo-BX-ooo?---M--ooM?-o-M-??MX--o-Bo-?o--oXM-oBX--?-?-XoM-o-o?-ooMMBB-oo-o?o-o-MT
oo-o---BM-X?XXo?oXM--B-ooB?--X---XoXB----B-B-M--oo?-----?o-B--B?---oXBo-B-oBoB??-BBo?-M-XMMo---?-?-?XB??-X----?--------BXM?--oMM----o--???---M?-Mo--o-oBM-BX-MooBM--M-o-X-o---XoMMM?-XM?-o--oBoMMo-oMX-E
XM-o--?----oXB--oo-M---??----M-oo?o----MB-B-X---o--o-?oX-M--oX--M--Bo-?o------o-o----B-o------oo--Boo---oMX--o-Mo-?-M?oo----o--o?M-BB-M-o--M---M-oMo?M---o-X-oXoo-----?--M--X-o-oo--X---Bo-o----o?oB-?-v
T-----ooXo--B-o----ooXB--?BM-o-B---oo------M?oo-MM-M--MX?-o-oo---?--M--M-o?--?oXX--oBo--?oXM-X??------B-?---B?M-X--B--?-o---BB-B--?----?XX---X--oo---oo--oooooMoM?oo-B-?X-M-XoB-X--??EMo---B-Bo--o--B-M?
T-MBM--------MXBXooM---?-o--B--o-???MB---oo-oM?o----B--X-X???-X?o-oXoXo-------MX-MMM---ooM?-Bo--?oo-o----Mo--?o-oB?-XM--M-oM--o--o-MX?MooM--MoX--B?-MB??ooo?o?-o--?MB---oo--M--B-oo-M?-oE-o---B--oMo---o
oo-ooBoX-o----oo---o---ooo----oMM-----o?X--BMo--Eo---oo?-oo-----?M--o-X-oo---------oMMo?--oo-?-o--Bo-M-Bo-o-o-o-B-oBo--M-BM------o--B--?--X--M?-M-o-----BBB-?oooo?o--B--BM---B---X----MX---MoM-?BooX?-oM
oM-MX-?BX?-B?oB--X-BMX--?oMo--B--o-Bo--oo----Mo??B-o?B?ooM?-?MoM---MMoo-MBX-B?o-------Bo?B-BM-o-?--M--?-?-ooX--X-X--B-oo--o--Moo-MoB-o-oo-M---oM--o--XoB----oBoo--o-o--B----?-ooX--oo----oooMo---M-B-??X
M-M--B-o-o---X---X-------o-B--oB-M-o-ooo-o?--oo-o----o--o-o-ooM-o----MBMo--?oo-o---o-Mo----o--?X--ooXo-M-o-oMXo-o-X-o---MB?B--XMX-Mo-o?-X---o---?o--Moo-B--Bo--MXM--B----X--ooX-MME-?o-XoXo-------Xo-o-T
--o-oo-----o-o---oo---------To--X---EX-X--o-oo-------------XoX--oo-o--o-o------To-Xo--------XXo-----o---------o-X---XXo-o--oT--o-o--Xoo----X----o-o-ooX-------o-o-XXo--o-------X--X--o-oX-E-o-o----Xoo-E
m---oX----oXoo----oooo---Xo-|-X--oo-?oo------X----ooooo-----o---Xo-o-o-oooo-oo-|o-----ooooo-o-oo-o-oXX--ooX--oX-o-o--o-o-o-X|--o--oo----o----o-X-oo-o----X-------X---oo-----oo-X-ooo---oX-Boo---oo--Xo-?
XXXXXXXXXXXXXXXXXXXXXXXXXXXXXXXXXXXXXXXXXXXXXXXXXXXXXXXXXXXXXXXXXXXXXXXXXXXXXXXXXXXXXXXXXXXXXXXXXXXXXXXXXXXXXXXXXXXXXXXXXXXXXXXXXXXXXXXXXXXXXXXXXXXXXXXXXXXXXXXXXXXXXXXXXXXXXXXXXXXXXXXXXXXXXXXXXXXXXXXX
