?------------------------------------------------------------------------------------------------------------------------------------------------------------------------------------------------------X
o------------------------------------------------------------------------------------------------------------------------------------------------------------------------------------------------------M
|------------------------------------------------------------------------------------------------------------------------------------------------------------------------------------------------------|
M------------------------------------------------------------------------------------------------------------------------------------------------------------------------------------------------------|
B------------------------------------------------------------------------------------------------------------------------------------------------------------------------------------------------------?
M----?-?o-?-?BB-oM?oo--o---o--BoX-X-BXooo--M?MBoXoTo--B--oBXMBM??--o-MM--M-Boo?XXM-MB--B-Mo-oB-?oMo--MM--M?--M-XoXX?-o-----M?-o-?o-M--B-X-B?BX-Xo-oXXB-oX-o--BooX-MXXoMB-oMoX-B--MoTo-MooBB-oX-?--ooBB-X
|M-Xo-o-X--X---BM--??XMoo--XX?-Mo-oX-??B?X-----ME-|B-o-oXX-X-----ooXX--oX---X--?B----X?-M-BXM-o-X-o-?--o---Mo-B-----MXoXMX-----?-B---B-Xo?---ooXX---o-?---o---?M---M----M?--X?-oM-M|---??--B?M--Xo-M--BM
M--BB-o-?M-B-B---Xo--o-X?Bo-X-o--oo------?M--XoB?oX-MM??-Xoooo--Bo?-?o-----MXo---oM--?-M------M-o-----BMoMB-?--M-BB?-oBX-MMBBM----XXX-oX--?--?-M-----o--BoM-?-------o-o?----X----X-X-MM--o----?B??B--X-v
o??--X-B--B------oo--?-X-X-MM?-BMo??o-XoB--XM-o----o----oo-oBXM--M-o-??---?-Bo-----oB-o--Xoo-?-???M-Bo--B----B--?----X-M---o-----?Boo-X?MB--B----oX-BoX---------Bo-?-MX---B-?-M--?-?o---oB-M--------o--E
?---?-o-oM--o--BXM?o--M?XBo---?--?--oMB--o-X-BM-oM-X-----M??-M-M--oM---B-?-X-B-B--X?-o--BX----o----o-o-----?B--M--XBXMB-Xo-B???-X--M--o-------oo-M-o---oM-BM---X-??-o-o--o---o----M-oX----X-o-o-MoB?MB-T
M--B-MBo---B?------o?---M-M----M--Bo---MMXoo---XX----Mo-----o---?-?--Bo-?-?B----ooo--?Xo-XM---Xoo-Bo----oXB-----o---B---X?-----oE?X-?BBXo-BoM?XBX-ooX-MB-----M?BB--?B-??-M---?-?---MB---M?-B---?-B----o|
-?-----XooB--o----o?-BoB---M--M--o-XB-?--Bo--X?Mo-B---M-oo?B?MX--B-o?-X------B--B?X-o-?o---XBM?MM?--XoM-Xo-o--?BMoM--X--X-X--XBB?------?M?-?--B---MXXM--BBoo------B--------X----o----oB---?-o?----?M-o-E
o--BB---B?--??o--oX-X-?------B--o?E--?-o--XoTX--X---X---Mo------?-----?----M?--?--o?-M-?---B------o-X?-----------M-M---?MBXo----B--o---X---------?--------?BM-o------oBooX-M-o-Moo-o-M---M----BXo----?-X
ooo--?B---BB--?o-?o-oX---X------?-?-X-BB--oXX---X-XBX-BXBBBB--o----------B---oB--XX-----?oT--T------o-o-o----B--X-T-B--------B?B-BX?--BXo------oB-Boo?X-?-------o---To-BoX-------o--?-??o---X------T----
mo?-o--oXB-----oo-B-ooXoo??-o--B-oXXBB--o-X-?-o-BX--B?-------?----oo-------?-X-B-XXo--o--B|X-|--?oooXBB-?o--o--oB-|--?o?-oXXo---X---X--Bo--X?-oX-o-??-XX--o-oo--B--o|X--X---o-B-?Xoo-X--?o-oo-oBo-o|---E
XX-XXXXXX--XXX-XXX-XXXXXX--XX-X--XXX--XXXXXX-XXX-XXX--XXXXXXX-XXXXXXXXXXXXX-XX--XXXXXXXXX-XX-X-X-XXXX--X-XXXXXXX-XXXX-X-XXXXXXX-X-XXXXX-XXXX-XXX-XX--XXX-XXXXXXX-XXXXXXXXXXXXX---XXX-XX--XXXXXX-XXXXXXXX
