--------------------------------------------------------------------------------------------------------------------------------------------------------------------------------------------------------
--------------------------------------------------------------------------------------------------------------------------------------------------------------------------------------------------------
--------------------------------------------------------------------------------------------------------------------------------------------------------------------------------------------------------
--------------------------------------------------------------------------------------------------------------------------------------------------------------------------------------------------------
--------------------------------------------------------------------------------------------------------------------------------------------------------------------------------------------------------
-XXM-?-BM-B?EM---BX?---XX----Bo??-B-----?--?---MM--M--M-?o-MX?--?MM-?M??-M--?-MoB--M?---?-?-XX-----?---MM-o----X---E--oBo---MB--MBX-?-M?---?XM--XX---BX-?-BB-oM--M?--XoXMXo-M--X-?X--TM-??-BooB?B?M?----
----?------MM--?--o-??-?-?BM?-M----M-M?M-B------o--o-?-B-BXo---?-o---o-o?---o-------o--M--o--B-oXB--?XB---X?-BXX-MX?X-B--M?M-----o--o---X-M---B-?-o---M--B--B?-X---X--B-oXB--B---oM--|-?o---?B-oo-o--o?-
-M---oMXoX---oX-o-MX-o-------?o--oB---o----XM--XB----oM---MX-o----X-X-Bo------TB----B-M--X--o-?XMo?----?--B---?--MXXo--MB--o-??M-oMB?M-M-------B-BBXMX-X--M----XX---X-oX---E--?BXMo--XX-X-M----B-Bo-BM-v
-------B?--X-?-M----M---X--M--?XB---?-o?-----XM--XMM-B-----BBo--X-M--X-MXX--B-|--M---?-B-oBM?B----oX?-X-M?--B---M-X----o---M----?-----?-o---XB-----?-?--o--M-----MoB----?--?----M--X-----o----?o--o----f
--X--M--?-XE?----M-o----M--o---o---X-BM-Xo?M--o?--o----M-----Mo--M-B-?---M-X--X--oM--o---M----BBX--M--?M-----X-Xo-?--?B?---oo-o-oB-X--oXBX-X---X-BX----MM?--?B-X--?-------M-B-?---B---??XM-?-------X-X-f
--X-oo---BM?-o?---XM----o?B--MBB---M-o---X-oBX--BX--B----E------?-B---?-?-BB-X-X-M--??--?--X?oo-X-B-M--o--B--?--B-o?-----M---BMM---MX---o?--B-----B---X-X-o------Bo--B-M-----?---MoMX-o--o-o-BX-?--X--?f
-?o-?--?M----B--?M?oX-------Boo--B?-MB-?------X--B-?-XB--BM-?XMo----X-o------M-??oXX---------Bo-o-----M-------X-o?Mo---XB--------M----BM--??--?M---XXM-----B--MX?-------M?-B--X-?---M--X-B-o?-?X-B-XBM-f
---E--EooX--B-X-o--X-B-----Eo-?-----ooM-XBX?-?M--o---?--XM-E---B-?E?-o------B-?----?--------o--?XMoM-X---M--M-?XB--?-XBB----MM-BM--X-E-----------------BX?-o--o---?---B-o-X-M-?--X-----?T-BB----B--M---f
--XB--X---o-o--X--------XBXMX---------oo--o-X--X---------o-X-----?B--XX----XoXoo--X-X--X-----------o-----o------o-B-----------E---oT-B----XX---X-X-E-----o--------------------oo---E----|--------------f
m-------------X--------X?-------------XX--------X--------o------------o---------X----------X--o--Xo----X--X----------o---X---MMBXX-|-----XX------MX?B------X-----X-X------oT----X--XX---|------oX------X
X-XXXXXX-XXXXX-X-XXX--XX-XXXX-X-X--XXXXX-XXXXXXX-XXXXXXXXXXXXXX--XX-XXXXXXXXXXXXX-XX--XXXXXXXX-XXXXXX-XX--XX-X--XXXX-XXXXXX-XXXXXX-X-X-X-X-X-XXXX-XX-XX-XX--XXXX-XXX--XXX-XXXXX-X-XXXX-XXXXXXXX--XX-X--X
