o-------------------------------------------------------------------------------------------------------------------------------------------------------------------------------------------------------
?------------------------------------------------------------------------------------------------------------------------------------------------------------------------------------------------------|
|------------------------------------------------------------------------------------------------------------------------------------------------------------------------------------------------------T
?------------------------------------------------------------------------------------------------------------------------------------------------------------------------------------------------------|
X------------------------------------------------------------------------------------------------------------------------------------------------------------------------------------------------------o
E-o?-?B--Bo?-X--X?----?BBoBEME-Mo------?-B?--?o--BoMo?Boo?B-o-BB?M-BMX--ooMEBo?----M-ME-MB-X?oBMMoMoM-B--?o-XMo-o-?-EoB-MM-X-?BMM?Mo?-oXo-MX-MBBoX-M?oX?MoBB?E?-X--oooMX-o---oBBo--MXB-oM---oBo------BB?
??----o-o--o---o----o-----XB-B?oEoBo?---o-oo-o--X-?-?--X-o-?o--------Bo-XXBX---MBB--?-?o--oX-?---M-X-ooBo-B??-o-M--XXEo-o-E-o------B-X?BB--o---oB-o--MM--E---M-o---X-M-MoB?-oM--Xo--X-----X?--B-MM-?-o-T
?--MXoo-MB---Moo--EoXB?--XMM-Bo-?X-?-Mo-M--?---?oXoB--Bo---o---o-MM--oM?oB-o-o----?B-TBo-o-?-oB---o--MEo?----EM--EMo-MM--MB-X?-?--XBX----?oBB-Eo-Mo-o---T?-o?--EX-Xo--o-M-o-M--?X--o-X?o--B-oo----XoBX?v
XM?oMo-?o---?-Xo--BXB--ooM--M----BB---B--o-oo----X-o?o-B-?--oo-Mo---?-o-ooX?BMMooo---|-?-?B-oMoB--Xo-BX---X--MooX?-oX--MMoXM------oo------?---Mo---MMBBB|MMMooo?B-M?---?-X-o--M-?-MXoM--X--oB?-M--M----T
B--o-?M--o-o-oBMoooE-M--Xo---o-ooo-oBX--?MooX-X?-MoB-?--o--XMBB-B-oM------?--oooT-o-oX?o?---o---o??M-oMXXEoo---X-o?---?--M--B-X--MX-?o-BX?o---?MX-?----oX---E--X-X----B--?--ooo----M-o--o?-Bo-?oXBoooo?-
?-??M--oM?BoBM-o-oM?-o----------XMo--ooo---?--o-B-M---X?--?o---B-----o--o----M--|o?-MB------X---B-oo?Mo-o?B--?-?oB-o---?ooM---BMX-M?oBXoo-XoBoo----o-M-o--M?BMoX---M--o---o?-oXo-?B-B?MMooB-X---Bo-o-Mo|
|Boo---M--o---oXoB-BB?-ooX-X-?----XM-o-o?Bo-B-Mo--oBB?--o?--oo---?MM?M---XB?oBEoXX-Mo--X--ooEM?B-----o-?X---o---o--B|-ooX---oo-----o?oo--X?o-Bo---X--oXoX-oXXB--X-?-?B--E?--oB??--?E----B--EB-o---M?-ooM
oo-Xo-M--B-M-o?o-oM---BB--?EXo--o-?--B-X-------oB??-----?---?-Eo-Bo-M--oX---?BMB-MM-X--?-?B?X-o----XB----ooX-o??--o-X-?-XM--X?B?B?--o-X---oX-o-BoEB--X----?M--BE------X-B--?o-----B?-----X?B-oMo-o--MX??
---Eo-----Xoo----E--------XB--o----Xo-----oXMo-o---oX-oo----oX?-----oo---X----Xo---oo---XooXX-oo-o--o-o--XTXo----X-----Xo-Eo-o-o-----o--o--o-E---?-MM---oo-oXXBB-oXX--oooXo-X-o--oEX--o--M-X---o-oo--o-E
m--MX------Xoo--oX---o-|oXoX-X--Xo----o--------o-ooo-------oXoMo-oXoX------XX----ooX---o--ooXXooo-X-oo-X-X|XXo---oX-o-oXooBo-----oo--o-oo-XMMXM---oXoXo-oo-Xo-X-o--o-oo-ooX|-----XBo-|-?M-oo-o----o-o--|
XXXXXXXXXXXXXXXXXXXXXXXXXXXXXXXXXXXXXXXXXXXXXXXXXXXXXXXXXXXXXXXXXXXXXXXXXXXXXXXXXXXXXXXXXXXXXXXXXXXXXXXXXXXXXXXXXXXXXXXXXXXXXXXXXXXXXXXXXXXXXXXXXXXXXXXXXXXXXXXXXXXXXXXXXXXXXXXXXXXXXXXXXXXXXXXXXXXXXXXX
