|------------------------------------------------------------------------------------------------------------------------------------------------------------------------------------------------------X
B------------------------------------------------------------------------------------------------------------------------------------------------------------------------------------------------------X
B------------------------------------------------------------------------------------------------------------------------------------------------------------------------------------------------------E
X------------------------------------------------------------------------------------------------------------------------------------------------------------------------------------------------------|
E------------------------------------------------------------------------------------------------------------------------------------------------------------------------------------------------------|
Bo--M-E---o?M--?-----------Xo-Xo--o---ooB----o-B--oX-o--o--X-o--X?-M------?-o--M-ooXo--oo-o-o-o-oMoX--o-o-o-------oX?---ooo-X-o-X-o-------X-ooo?o-o--o--o-o-ooo----B-oB----o---oo-oo---EooooB--ooMo---oE
Xo-o--?-Xoo---M---o-----oo--o---o---o--Mo-------------oo----o-----o-oXo--Moo----o---BX-M---------o---B--o--?M--o-X-o-o----oo----oo--?-o---oooo-----o-------?---o--oo-o-ooooo--Bo----Mo-B---o-----o--o---
EM-----ooo---M---?----o----oo------o-----o?o-o-----o-----MM-o---o-o--------Mo---o-o--------------o-o-oo--X-------------o-----oo--Bo----XE--X--oo-B-o--o-o-?-X--o--o---oo-?X--o---------oX-------o-B----v
|------------o-?-----o----B--oBo---------o--ooo--o--------o--ooo--o--?oooB--o-o--ooo?o----o---oooo---oM--o--oo-o-ooo---o--o-------o----?Mo----Mo--Xoo--o-o---o--o--oo---o-?-oooo?-o-X-o-B----oo-----X-o?
o--o-o---------oo-o-oo--?-o--o-Bo-?-oo--?-B-?oo---o---o-o-o---M-------oB---X-o----o------oo----EX----oo---oBEoo--Xoo?-----oo----oM-o----o------oo--MB---o---o--EX---ooo-o---o-----o-o-o--oo-----o-o----X
B---------E-o-------oo---oX--oo------o-------Xoo--o----o-oo--o---oo--o----Moo--------o-o-Xo-o-?X----o-?X-----oXoX--o--o-------B------MM-o--XMo--ooo-----o----oXo----M--------o-B--oo----B-o---X--?--oo-T
Eoo-oo-oMXBM-o-o--oM--X---oo--o-o-?--------B---Mo---ooooo-o-o-o-oo?--X---?-oM---o---ooo-M-ooXooo-o-o--------o-Bo-o-----Boo-o------?-Xo-B-----E-oo-oo?B-------o-o--o------o-E-o--o---oo----oooBo-----?oo-
o?--o-M--o-M-oM-o--------o--o-oo--o-o--X-oo-o-o----oo-oB-o--oo---o-o--BX-o---------Xo-o?--B---o?---?oo----Bo----o--------Xo--o--Eo--o---o----B----------------B-oM--o----oXX--oo-o-ooEo--o-ooo-o--ooo--B
o--o-X------o----o--o----o-----o----o------------oo------o---o--ooo--------o---o---ooo--------o--------------X--o------o--o----oBo---o---------o---o---o-o----------o-E---o-----o----B------o-o--oo--o-|
mooo---o----X--o--o-X------oo-o---o--X--o------o-Xoo------o----o-o---X--o-o-o------oooo-o--o--o-o----o-o----o-----ooooo--o-oo--o----oo-ooXoooo-o-------o-o-o----ooo--MXo-oo--oo--oo----oo------oo---o--B
XXXXXXXXXXXXXXXXXXXXXXXXXXXXXXXXXXXXXXXXXXXXXXXXXXXXXXXXXXXXXXXXXXXXXXXXXXXXXXXXXXXXXXXXXXXXXXXXXXXXXXXXXXXXXXXXXXXXXXXXXXXXXXXXXXXXXXXXXXXXXXXXXXXXXXXXXXXXXXXXXXXXXXXXXXXXXXXXXXXXXXXXXXXXXXXXXXXXXXXX
