T------------------------------------------------------------------------------------------------------------------------------------------------------------------------------------------------------E
M------------------------------------------------------------------------------------------------------------------------------------------------------------------------------------------------------E
?------------------------------------------------------------------------------------------------------------------------------------------------------------------------------------------------------M
o------------------------------------------------------------------------------------------------------------------------------------------------------------------------------------------------------E
T------------------------------------------------------------------------------------------------------------------------------------------------------------------------------------------------------T
ooo----oX--o-oo------B-o-X--ooM------oM-?----o------?--ooBEB----oooEoo--Eo-o-ooo-oBoo---?--ooooo--o-------oo-ooB--M--Mo--o?o-ooo--o---X---o---oo--o-MoooM-oB-oMo-o--oo---?-BXo-----oo--?-o-ooo-ooo-B-ooT
?o---o--oooo-o-o-o-------oo-o--o------o---o-E---X-B--B-o-?M-------oB?B---oo--Xo---o---o----o--oo-o-o-M----o---XoBo-?o---o--o------Bo---oo--o-B-X-o---o-------?------o---o------M-oo-M-E---o-----Mo----BT
oo------o---------oo---oX--?ooooBo--oo-oMoo-?-Mo-X-----o---o-o--E-?--o-XoooX----o---oM---B-oo----------o----------X-o--Xo-o-o--o-----o--oMoX-----o--o----M------X----------B--------?BXM---o--oo--o----v
M--o-o-o---oE------o-o--o-o--o----M--o?-----M----oo-----o------oM----oo-M-------E-o----o-------o-o-oX?-o--o-----M-Mo-oX--o----o-o--o-B-o--ooo-----------o-o-o-oB---o-o-oo---o--o----o--X---o---Xo-MMo-oB
?------X----?-MM-----o-o---------------o-oo---oMo-------o--oBo-oo--o-----------??--o--ooooo--o-oo-o-----o-?---o-------o--ooB--o-o--o----o--oo---oooo------o--------ooo---?--ooo--MMo-----ooo------o--o-E
oo-o-----ooo-----o----M---?oX--M-BM--o----ooo-?--oX--oMo-o---o-B-BM-------------o-?Xo-oX---o---o-------B------o-o--o-----B---oM--o-M--ooo----o----oo------oo--Boo-----o--ooo-o-------o---XoX-BXo---o-XoT
oooo------o-?--o-------o----o-o-oo--X-?X---Mo----o--------ooMo---oo-o-o----ooM-M--o--oX-ooo--ooB-o------Moo-ooX-?oo----?-o-o--ooooo-o-oXoX--oE----o---o------o---o------?----o------B-oo--BoX-o--o-----?
|-o-o----o-----o---o-o--o----o-M--o-oo--oM-o---o---oMoo---oXoM?B----oo?---?-----M--Xo--o--Moo----o----M--o-----o-X----o---------o-o-?----o-?BBBo----MMB--ooo------oXBooo------o-X-B?----Mo-oo-BX--ooo--?
-------o-X---o--E----------o----------oo--o---o--------o--o--oo------o----o--oo-----o-o---------XX-o--------o--o---o-oo---oo--o---oX-----o---------o------ooo-o----o-------------o-----o----o--o--o--X--
m----o--o--ooo--M---o-o------oXo--oo-o--o-o--oooo-o--o---Xo--o-------oo-o--o--oooo-oo-------o--oo-o-o------oo-o----Booooo-ooooo--oo-------o-oo-o-oo------o--o-o----o-o--o-o-o---oo-oo---o---oo--o|ooo-oX
XXXXXXXXXXXXXXXXXXXXXXXXXXXXXXXXXXXXXXXXXXXXXXXXXXXXXXXXXXXXXXXXXXXXXXXXXXXXXXXXXXXXXXXXXXXXXXXXXXXXXXXXXXXXXXXXXXXXXXXXXXXXXXXXXXXXXXXXXXXXXXXXXXXXXXXXXXXXXXXXXXXXXXXXXXXXXXXXXXXXXXXXXXXXXXXXXXXXXXXX
