T-------------------------------------------------------------------------------------------------------------------------------------------------------------------------------------------------------
X------------------------------------------------------------------------------------------------------------------------------------------------------------------------------------------------------?
M------------------------------------------------------------------------------------------------------------------------------------------------------------------------------------------------------?
X------------------------------------------------------------------------------------------------------------------------------------------------------------------------------------------------------|
|------------------------------------------------------------------------------------------------------------------------------------------------------------------------------------------------------B
XBoE?-?--MoBB--M?M-BMXB-B---?Mo----?o?MB?--oBMX-oXo-MoB?o?XB-B--E-o-M-X?-o-B?B-?T-XBB-BM--oX-M-XXoM?-?o-XMoBB-o?M-XB-o-M-?-MBoB?Bo-XB-o---?o?E-M-M-BoMoBo?BXoo-X-M--BXo-Xo?B???-X----?o-?-B?B-M?Mo--MM-T
--MX-?--B----o----?--E-B--M?--?X--B-M----o-X--o---EM-o--M-M-o-XBBMoo-o---M------|oo--B----XBo-oM?---T--------M---oo-o-?---o--X---X?o--o?---MB??-----?-o-?---M??-M----XB--X-----BBB--M-?B---------?-M--?T
M--B---X--Xo--M-Xo-BMM?------o-oo--X-o--?X-EB-B?o?X--M---o-oB---o-MBoMMB----BBo-XMXM?-oMBE--?BB-----|?o?o-o-?-XoMoX-?---o-BB--o------Bo-o-----XB-----B-----o---o--MB---EXXo--o----M?----X?M--oo---M-M--v
M---o--M--oMM--o?M-o?BX-BoXB--o-Mo--XB-BoXMM----------BB-?B----M-o--o---BBoX--?-o-X--??--?Eo-----o--X-oX?MBB--BX-oMo-?-Boo--oX?-XB-oo-M-MoX-oMo-M-oBX-?B-BXM?--Xo----o-BMo-X-?--oX--BoE----?-MoX-?-M-Xo|
M-X-oo----B--------?-----oo-M-BX--o?--M-MM??-Bo-B?--?---B---o-o-?M--o--X--X--B----X------?X?o??B--B-E-XBMX-MXo---?-X----oMMBMo-Bo-E----o-?----o--Eo-oM----B----o---M-XBM-?-o---MM----MM--Xo-o-oX------E|
B??o?--E?M---Bo---E--oTo-??--o-MM-o-M--B---o--XB--?--B-X-?--B-M---o-X?-M---M---Xo-B-oB-B--o-X---XX--?-XoX-X--XoBo-XMMMBoEB?--B--?BBM?-BXB--B--MMMBMoM---Mo--E-MM----B-----oXBM-----Bo----MB--EoMo-oX-?MT
M--M-M?M---oo-Mo?oMBMMXX-----M---???------?-M--MB---T--BX----o-BoXM?X-o-M-M-o--?Mo----B----X?B--E----B-XX?o------?o----??--o--?o-oo----o-----o--X?B---XM-MM?BB--o-?---??o-M------oo-?-MB?--oXBo--X?B?-oX
Xo----?B?--M-M-M-oM---B?BXBo--o?----B-?o---------?BX|MX--Bo-BB--MB-B-MMM-?--Xoo--E-oo-----oB---MM-------B-BBo?-XX-B--XX-X--X-M-BMBXM-?-?X-T--o--o--M--o---oBB-MX-----o--X--B-----?M--M----M--BXXXX---o?T
TB--------X-X---X--o-------BB-?--oE--B-o--o-X---o--?X-X-B--X--oB--o-?--oB--X-Xo??BBBBX-Eo-B---X-oX--Xoo?--------?--?-X?X--o?o-------?-----|?-?X?X-------X-X----------?-Bo----Xo-o--?--B-X--oB-XX-X---T-M
m-oBo-o?X-XXoo?Xo?-ooX-oB-o--o---B?Bo--X-XXB-o--BoB-X-o----B-oo-o----o-?-----o?--XB--MBXXo-X|o--o?-oXo---|o?|?o--X?-BB--X-B-B--o--o--?o?oBX---B-?Bo--X-|oo-M--ooo-X-B-o-B-B?o?--X??-BB-oo--o-X-Xoo-oo|-M
X-X-XXX-XXXXXX-XX-XXXXXX-XXXXXXXX-X-XXXXXXX-XXXX-X--XXXXX-X-XXXXXXXXXXX--XXXXX-XXX-X-XXXXXXXXXXXX-XXXXX-XXX-X-XXXX-X---XXX-X-XXXXXX-X-X-X-XXXX----X-XXXXXXXX-XXXXXXX--XX-X--X-XXX--X--XXXXXXXXXXXXXXXXXX
