?-------------------------------------------------------------------------------------------------------------------------------------------------------------------------------------------------------
?------------------------------------------------------------------------------------------------------------------------------------------------------------------------------------------------------?
X------------------------------------------------------------------------------------------------------------------------------------------------------------------------------------------------------|
X------------------------------------------------------------------------------------------------------------------------------------------------------------------------------------------------------X
E-------------------------------------------------------------------------------------------------------------------------------------------------------------------------------------------------------
E-X--XE?oME?MXo-oo-X?EEo-?XoooX-?M?Mo----Xo?o-Mo--?XMX-?E?MXEB--EMEMB-E-EMXBBBX-----E?---BM-EB-Bo-oB?-BE?MoXMBMoEXMo?X-XXEXo-XBoE-oX-E-o--X-MEMoBXBM--M-oX?-E-M-X-M-BM-EEXo-oo?XoXEXoo-M?o-oo-EoMMoB-B-o
TMMBMo-?BXMBEo-XB-?-??X?-BoBBB??-----EEXM-o---MXB--EMX----oBoM-MBB-?--E-??oo---o-BoB?Mo-?X?-o-ooo--oEoB--oMEXEEo-EoE-o-----Mo--B?X-oM--X-BMM?XXEoME-E?-o---?oE-Mo-BBE--o?M---BM-o?XMEo?-M--EX-MooE-Xo--?
--o-XE-o-o-?oo?BoXo??Eo?-?M-XEMME--B-?Xo-Bo--BBB?EX?MMBEB?E-?E?---?MXM-XXXoXEMB---o--Moo-oo-o-MEEoE-XMX-X??BBEXBM--EM?---oB?M-XoMBB---o?o-?B-o-M?E--BMB?oM-X--EXB??B-MMX-BEoE?-X------X-X-oM??BoEMXMoB-v
?B-BEXMBB-BXoXooXo---ooMM--EoBooXX---BMB-B-BX-M-???MXXEoEB-??ooMEooMEMBo?E-M?X?o--oMoo-oMB-XBM?BoMB---BEEoo-o-BBBo---BX-o-B-?Bo---Eo-X--o---?-X-EMB?MM--?-oBEM----XoEX-MEM--B-X-oEBMBB-?-BBX-?X-B-ME-XX-
|ooBEEM-MEMM-?Bo---M?-oM?--BMXB-?oB-B?o?EoE-o--XM?-oo-?-EoB--EBEo?-?o-oBB-oXo?MXo-MXXXBM-oX?-E?oo?M-Mo--oEE?ooo-ooM-o-?BEXX-oB-EX-o-o-E?oE-X-EooBB-??-EBB?oMoEoB-X----XMoMo-B---?MMXoB-BoE?M?-E---?BMB-M
EB--oBBX-XoBM?--oEXoM-o-BB-?XoB-XooXoo-XEoXEX--M-ooE-B?-E?-BMBEX-XoMX?oEB-Xo---ME--EBXXMoBoMX-?XoX--o-?Bo-XEX-EXB-oo?E---MB?Xo?X----B-XX-XM-E?EXX-oo?M?BXo-BMEEo-EMMEooM-?EBoBoo-ME-B-?MoBEXME--?E-EX-B-
?--XoBBXEMo---o?--oBoXMoo-?-MBBE-MB??-oBEMBB?-M?XE-E-BBBEEBEE?BM?E----?MME-EMoBMo?MX-o?B-B---EoM-BXMXXEMoEEEEoX--ME?B--?EEE-X-?--oX-XXo-B-MBXB--B-o---M--oEXBE---oXMoooooBE-EEXXMMMooME-ooMo-EXoBBo-BMXB
MXB-?oBB-oM-EooB-XX-oXXEBE?Xoo-Bo-Bo-BEX-oMB---o-?-ooo-oB-X???o-?M--Bo-oBoBoXM--BMXBE?-XEXBMM?o-Xo-ME--XB-?M?X-BoM-M-?-Xo-M?Mo-M?-oMXE-ooEEMX?B-----Mo?BEE-?-X-?oMB-BBE-?o-XoX-Xo?MXX-EB-MBMEEBXM--BEBEo
X--oEBB-E--?-X?XoX-B-B-XBXBBX--XX-o-oooXoXXB--oEBo---BB?oB?-oXo-XB-?-ooo?o--oB-X-Xo--B?XXX-Bo-oo-EEo-o----E-----XoBo?E?---o--o-XoEBB-B-ooEEBBBoXo??-X?EXBo---EB----o--???---BBXo?EoXoBo--?Bo?--oBo-X----
m-E?-oE-B?X?BEXo-?----?-?X-B---?o-?oXBoo--BX--B?XooEo---EE-B-BoB---Eo----XE-ooo---XX-XXBB--?---EooBo-?X-?-----X-?X??----Booo---B?-X-EX-E--oo-??oEBXX-oB-oB-BE-oE-XoEX-X-X---?B-?--o--X-oo?X-E??B--B?-BoT
XXXXXXXXXXXXXXXXXXXXXXXXXXXXXXXXXXXXXXXXXXXXXXXXXXXXXXXXXXXXXXXXXXXXXXXXXXXXXXXXXXXXXXXXXXXXXXXXXXXXXXXXXXXXXXXXXXXXXXXXXXXXXXXXXXXXXXXXXXXXXXXXXXXXXXXXXXXXXXXXXXXXXXXXXXXXXXXXXXXXXXXXXXXXXXXXXXXXXXXX
