T-------------------------------------------------------------------------------------------------------------------------------------------------------------------------------------------------------
X------------------------------------------------------------------------------------------------------------------------------------------------------------------------------------------------------?
M------------------------------------------------------------------------------------------------------------------------------------------------------------------------------------------------------?
X------------------------------------------------------------------------------------------------------------------------------------------------------------------------------------------------------|
|------------------------------------------------------------------------------------------------------------------------------------------------------------------------------------------------------B
XBoE?-?E-M-BB--M?M-BMXB-B---?Mo---o?o?MB?--oBMXEoXo-MoB?o?XB-B-----EM-X?-o-B?B-?T-XBB-BMEEoX-M-XXoM?E?o-XMoBB-o?M-XB-o-M-?-MBoB?Bo-XB-----?o?E-MEMEBoMoBo?BXoo-X-M-oBXo-Xo?B???-Xo---?o-?-B?B-M?Mo--MM-T
-??X-X?MM----o----?----B--M?--?X--B-M----o-X--oB---M-o--M-M-o-B--XMX-o---M------|o---B--M?XB--oM?--XX--------M---oo-o-?---o--X---X?o--o?---BXMBBXM?-?-o-?---M??-M----XB--X-----BBB--M-?B---------?-M--?T
M--B---X--Xo-EM-Xo---oo-----Eo-oo--X-o---X--B-B?o?o--M---o-oB-----MBoMMB----BB--XMXM?-oMBE--?BB-----|?o?o-o-?-XoMXBB?---o-BBE-o------Bo-o-----XB-----B-----o---o--MB----XXM--o----M?----X?M--oo---M-M--v
M------M--oX?X-o?M-o?BX-BoXB?-o-M---XB-BoX-E----------BB-?B----XMM--o---BBoX--?-o-X--??--?Eo-----o--X-oMMX?B--BX-oMo-?-BooMMMB?-XB-oo-M-M-X-oMo-M-oBX-?B-BXM?--Xo----o--Mo-Xo?--oX--Bo-----?-MoX-?-M-Xo|
M-XMoo--ooB---E----?--E--oo-MoBX-Eo?--M-MMB?-Bo-B?--?---B---o-o-?M--o--X--X--B----X-----B?BMo??B-oB-E--o-E--Bo---?-X----oMXBMo-Bo------o-?-------Eo-oM----B---oo---M-XBM-?-o---MM----M---Xo-o-oX-----oE|
B??o?---?M---BX---E--o?o-??--o-M?Bo-M--B---o--Bo--?--B-X-?--B-M---o-X?-Mo--M---X--B-oB-B--o-X---XX-MM-XBMXB-EXoBo-XMMMBoEB?--B-----??-BXB--B--M?XBMoM---MoXBX?MM----B-----oXBM-----Bo----MB---oM--oX?M??
M--M-M------o-Mo?XXBMMXX-----M---B--------?-M--MB---T--BX----o-BooMMB-o-M-M-o--?Mo----B----X?B------EB-XX?BB??---?o----MB--o--?B-oo----o--------X?B---XM-M---M----?---??o-M------oo-?-MB?--oX-o--X?B?-oX
Xo----?B?--M-M-M-oM---B?BXBo--o?----B-?o---------?BX|MX--Bo-BB--MB-B--M--?--Xoo----oo-----oB---M--X?M---B-BB-?EXX-B--XX-X--XEM-BMBXM-?-?X-T--o--o--M--o---oBB-MX-----o--X--B-----?M--M----M--BXXXX---o?T
TB--------X-X---X--o-------BB-?--o---B-o--o-X---o--?X-X-B--X---B--o-?---B--XEXo---oBBX--E-B--EX-oX--Xo-?------B-?--?-X?Xo-o?M-------?-----|?-?X?X------EX-X----------?-Bo----Xo-o--?--B-X--oB-XXMMMM-T-M
m-oBo-o?X-XX-o?Xo?-ooX-oB-o--o---B-Bo--X-XXB-o-oBoB-X|-----B-o--oo---o-?--MMBM?--XB--ooMMo-M?MXTo?-oXo---|o?|?o--X?-BB--X-B-Bo-o--o--?o?oBX-T-B-?Bo--X-Boo-o--o-o-X-B-o-B-B?o?--X??-BB-oo?Mo-XoX?oTooBXM
X-X-XXX-XXXXXX-XX-XXXXXX-XXXXXXXX-X-XXXXXXX-XXXX-X--XXXXX-X-XXXXXXXXXXX--XXXXX-XXX-X-XXXXXXXXXXXX-XXXXX-XXX-X-XXXX-X---XXX-X-XXXXXX-X-X-X-XXXX----X-XXXXXXXX-XXXXXXX--XX-X--X-XXX--X--XXXXXXXXXXXXXXXXXX
