B------------------------------------------------------------------------------------------------------------------------------------------------------------------------------------------------------?
X------------------------------------------------------------------------------------------------------------------------------------------------------------------------------------------------------M
-------------------------------------------------------------------------------------------------------------------------------------------------------------------------------------------------------B
o------------------------------------------------------------------------------------------------------------------------------------------------------------------------------------------------------o
o------------------------------------------------------------------------------------------------------------------------------------------------------------------------------------------------------M
EM?--o?-----o---?--Mo-o-o-?oo-o-o-B-----oMo-M-o-?------o?o-o--B--o-------B--o---?-ooE-o----o-oo-?oE---oo-oo--o?-X----oBE-o--B-?-EXX-?----oBo---o?B-o-o-o-Xo-o---Mo-?-o-oo----o-?-BXo---oX-oo-------o-o-M
M--o--o-----oo-o----o-Xo-o--o--M-X------?-o-o-----ooMoo--oo-X---E--E-----ooo------o-?---o-Mo-o---X-----o-o-----------oo-o---o--BBoo--o-o-o-----o---o-o?o-o-X-----oo------MM--------B---M--oo----oo----oM
|---o--o---?-o-o-o---o-o--B--------oo----ooo-ooo----o--M--o?o-ooM--XB-?o---o-o--Xoo-o-B-----M-o----o-o--------B----------oME--o--X?-oo-o-oo------oX-oo-----------o---o------o--ooo-----oo-----oo---M---v
E-?oo-o-?-o---oMo-----?-o---X---o---M-?----oo----oo-ooo--o-----------o---o---o-o---?-M--o?----o--o-Mo-oo-----o-o----o---oMBMX--oo--oo-o-oo-X----?---o-o------o---E---o--o-------BX----ooo-o-B----Mo-o-oX
E------o-oo---?-?oo--o-------?o-?oo---o-----oo----X--X-------?----------ooX---oM-------------o-----------oo---------?-B-o------o--B?o-o---?oo---oo-----o-o-----XXX-X----M----o---B----oo--o---?-o------|
M-oX----?-----o---oo--o-----B--o-----o--------o----o-o--------?o--o-----o--Bo-Xo----------o-oo----oo--o-?M-------B--------Eo------o--oooo---oX----oB-----o-o-----o--Xo--o----Eoo--oo-o?-o------o-o-o-?-o
|-?o-o------o---?------oo--Mo----o---Xo-M-o---o-oo-M-?---??X----ooooMo----?---------oo---o--o--o-------------X-X-o--M--oMMBX--o-oo-o--oo----XM--------------oo---o-??--o--oB-MBoXM?------o--o----X--B--o
?-o--M-----o---oooo--o--------o-----XX-----o--Bo-M---------------E----X--ooX--oo-MMo----o?-MX-o?-o-o--o------o----X--o-?---------?Moo---o-?-o---o----o-X-o-o---o--o---o--o---oX------o-X--o-X-----o-----
oo--------o--------o--o----o------ooXo----o---oo----oo-----o-----M----------------o----------o----oooo---oo-o-oX-Eo---o----------o-o---------o-------o---o------o----------o--o-----o-----o---oo-o--o---
m-----o-o--o--o--ooBo--o-ooo-o------oo-ooo-ooo-oo--o-oo--oXoo----o-X-----oX-oo-oo-o-o----oo-oo-o--oo--o----ooo--oM--o-o-o-oo-----o----o-------o--o-o--o-------o---oX---o--o-o--o------o----o-----------T
XXXXXXXXXXXXXXXXXXXXXXXXXXXXXXXXXXXXXXXXXXXXXXXXXXXXXXXXXXXXXXXXXXXXXXXXXXXXXXXXXXXXXXXXXXXXXXXXXXXXXXXXXXXXXXXXXXXXXXXXXXXXXXXXXXXXXXXXXXXXXXXXXXXXXXXXXXXXXXXXXXXXXXXXXXXXXXXXXXXXXXXXXXXXXXXXXXXXXXXX
