--------------------------------------------------------------------------------------------------------------------------------------------------------------------------------------------------------
--------------------------------------------------------------------------------------------------------------------------------------------------------------------------------------------------------
--------------------------------------------------------------------------------------------------------------------------------------------------------------------------------------------------------
--------------------------------------------------------------------------------------------------------------------------------------------------------------------------------------------------------
--------------------------------------------------------------------------------------------------------------------------------------------------------------------------------------------------------
-XXM-?-BM-B?-M---BX?---XX----B-??-B-----?-o?----M--M--M-?o-MX?--?MM-?M??-M--?-M-B--M?---?o?-XX-o---?---MM------X-------B--o-MBo-MBX-?oM?---?XM--XX---BX-?-BB--M--M?--XoXMXo-M--X-?Xo-TM-??-B-oB?B?M?----
---o?----------?----??-?-?BM?-M----M-M?M-BB------T---?oB-BX--o-?-o------?o--o-------o--M-X---B--XB--?XB----?-BXX-oo-M-B--M?M--?----o-M--X-M-EoB-?-o---M--B--B--X---X--Bo-BMM-M--o-M--|o?----EB-o------?-
-M--o-MXoX----X-o-MXo--o-o---?----B----o----M--XB|----M---MX-oXo--X-X--o------TB----B-MooX------Bo?----?--B---?---X----MB-o---oM--M-o--M----?o-MoBMXX--X--M-o?-XX------X------?BXMo--XX-X-M-o--B-Bo-Bo-v
-o---o-BM--X-?-M----M---X--M--?XB---?-o?-----XM--XMM-B--------B-X-M--MBXB---B-|--M---?-B--BM?Bo----X?-X-M?-oB-o-MoX---o----M-o--?-o-o-?-o---XB----o?-?--o--M-o---MoB----?--B----Mo-X----?-o---?------o-f
--X--M----X-?----M-o----M-----oo-o-X-XX-X-?Mo--?-------M---M-M---M-B-----M-Xo-Xoo-M------Mo---BBX--M--?Mo----X-X-o?-X?B?---------B-X---B?X-X---X-BX-M--MBM-o?B-X---o----XXB-B-----B---?XoM-?--o-o--XoX-f
-----o---X----?---XB-----?B--B?B-X-M--o-----BX--BX--B---oo---o--?oB--o?-?-BB-?XM?M--??-o?--M-o--X-B-------B--?--MX-?----BX--XM-B---MX--o-?-EB----oB-o-Xo-----o---B---B-M-----?---M-MX--------BX----X--?f
-?-o---?M--o-B--?-Moo-------B--o--?-MB-?----o-X--?-B-XB--MM-?XM-----X------o------XX-o------BM------X-M---o-ooX---Mo---X-?-------M----BM---?--?M---XXM-----Bo--?o-------M?-B--X-?---M-oX-B-o?-?XoB-XBM-f
-o--M-?--XXXB-X--?---B--------?-------M-XBX?-?M------?--XM-Eo--B-?-?----Eo--B------?------------EM---Xo--M--M-?XB--?-XBBo---MM-BM--X-----oE----o--o----BX?-oMM-oB-?---B---XoM-?--??-o--?---M----Bo-M---f
----o----o-----X--------X---X-------E------oX--X-----------?-----o----o-X--X------X-X--XX---o-o-?o--------o-------M---ooo-----Eo---T----E??To--X--X----------------------o------------o----------------f
m----------o--X--------XX-----------M-XX----o---X--o------o-----------o---------X-------X--Xo-M-XX-----X--X------oXoo--o-X----XX-X-|--??X?X|--o--XX--------------X-X-----X------X---X------o---oX---o--X
XXXXXXXXXXXXX-XX-X--X-X-X-X-X-X--XXX--X-XX-X--XXX--XX-XXX--XXXXX-X--XX-XX-XXXX-XXX-XXXX--X-X--XXXX-XX-XX-XX-XXXXXXXX-X-XXXX--XX--XXXXX-XXX-X-XX-XX-XXX--X--X-XXXX-X-XX-XXX--XXX-X-XXXXXXX--XX--X-X-XXXXX
