--------------------------------------------------------------------------------------------------------------------------------------------------------------------------------------------------------
--------------------------------------------------------------------------------------------------------------------------------------------------------------------------------------------------------
--------------------------------------------------------------------------------------------------------------------------------------------------------------------------------------------------------
--------------------------------------------------------------------------------------------------------------------------------------------------------------------------------------------------------
--------------------------------------------------------------------------------------------------------------------------------------------------------------------------------------------------------
-XXM-?-BM-B?oM---BX?---XX----B-??-B-----?--?----M--M--M-?--MX?--?MM-?M??-M--?-M-B--M?--o?-?-XX-----?o--MM------X-o-----B--o-MB-oMBX-?-M?---?XM--XX---BX-?-BB-oM--M?--X-XMX--M--X-?X--TM-??-B--B?B?M?--o-
----?o-o----Bo-?----??-?-?BM?-M---oM-M?MoX------oM---?-B-BX----?-o---o-o?--------------M-----B--XB--?XB---?M-BXX-?M-M-B--M?Mo--M-------oX-M-o-Bo?-Eo-oM--B--BB-X-o-X-----X---M-?M-M--|-?-------o------?-
-M----M?o?----X---MX--------o?----B----o---?M--XB-----M---MXM-----X-X-Mo-o----TB----B-M--X------B-?---o?o-----?--ooX---MB----??---MB?M-M--o-M--MBB?XM--X--M----XX---X-?X--oo-o?--M---XXoX-M--M-BoX?-X?-v
--------M--X-?-M----M---X--M--?XB---?-o?---ooXM--XMM-B------oXBoXoM--X-B----B-|-oM---?-B--BM?Bo----X?-X-M?--B---M-X-E--oo--M----?-----?-o---oB-----?-?---o-M---o-M-B--o-?BMX---oM--X-----?----?------o-f
--X-oMo---XE?----M------M---------oX--X-X-?M-T-?-------M---M-MoM-M-B-?---M-X--X-?-M------M---oBBX--M--?Mo----X-X--?-M?B?------o--B-X---MMX-X-o-X-BXo--oM-M--M?-X--?-E----o--BBM--oB-o-??-o-?-------X-X-f
--X-o----B?B-o?---X------?B--MX----M--X-----BX-oBXo-B-----------?-Bo--?-?-BB-XoX-M--??--?--MM---XoB-M-----B--?--B--?---o-?---XXM---MX----?--B----oB---X-X----o--oBo-XM-M-X-------M-MX-------oBX-?--X--?f
-?--B-o?M----B--?-M-X-------BoX?-B?-MB-?------X--B?B-XB--BM-?XM-o---X---o----XB?--XX------------MX----ME-----oX-o------XB--------M----BM------?M--oXXM-----B---?B-------M?-M--Xo?o--M--X-B--?-?X-B-XBM-f
-o-E--B-oX?XBoX--?-X-B--------?---o---MoXBX?-?M--o---?--Xo-----B-?o?--o-----B-?-o--?------E--M-----MoX-B-M--Mo?XBEE?-XBB-----M-BM-oX---o------oo--E--o-BX?-o------?---B--oXoM-?B-X-----?--------Bo-M--of
--?M--o--------X--------X------------------oX--X------------------X---X----X--o---X-X--MB?XM--E------E------ooo-oXB---oo-----o-----T-------X---X-X?-------------o--X---------o-------------------------f
m-------------X--------X?-----------o-XX---o----X--------------o----------------Xo----o----XoMM---o-?B-X--X--?-----------X-----X-X-|-----XX------X-------?BMB----X-X-------T----X---X--X--------X---o--X
XX-XX-X-XXX-XXXXXX-XXXX-XX-XXX-X-XXXXXXX--XXXXXXXX-XX-XXX--XX--XX--XX-XX-XX-XXXXX--XXXXXXXXXXXXX-X-X--XXX--XXXX-XX-XX--XXXXXXXXXXXXXXXXXXX-XXX--XXXX--XX-XXX-XXXX-XX-X-XXXXXX-XXX--XXXX-XXX-XXX-X-X--X-X
