?------------------------------------------------------------------------------------------------------------------------------------------------------------------------------------------------------o
-------------------------------------------------------------------------------------------------------------------------------------------------------------------------------------------------------|
o-------------------------------------------------------------------------------------------------------------------------------------------------------------------------------------------------------
-------------------------------------------------------------------------------------------------------------------------------------------------------------------------------------------------------|
T------------------------------------------------------------------------------------------------------------------------------------------------------------------------------------------------------E
M-oMB----oo--oMoB-----B-?oo?M-M-MXoo--B-?---?-B?----M???X?-o-o-oMMXBoooMXXB-?o--o-oB-Mo----B?o-oB-?X-ooooo--M--BX--B--X--o-BX-ooo?-o-M----M?---M-??MX--o-Bo-?o--oXM-oBX--?-?-XoM-o--?-ooMMBB-oo-o?o-ooMT
oo-----BXBX?X?oX-XM--B-o-B?--X---X-XB----B-BoM--oo?---o-?--B--B?-o-oXBo-B--B-B??-BB-?-M-XM-----?oo-?-BXXXX-o--?----o--oXBM?--oMM---Mo--?-o----?-M---o--BM-BX-MooBM--M-o-Xooo--X-MM?--XM?---o-BoMM--oBX-E
XM-o--?o-o--X----ooM-o-??----Mooo?-----MBoB-X---o--o-?oXoM---X---MBoo-?o-----o--o----B-o--X---o--XBoo-o-oMMM-o-Mo-?-M?------o--o?---B-M-o--M---M-oMo?M---ooX--o-----oo?o-M--X-o----XX---B-o-o-o--?oB-?-v
To----o-Xo--B-----oooX?--?BMMoMM----o------M?oo-MM-?--MX?----o--o--oM--M--?o--o-MXooBo--?-XM-X??----XoB-?-o--XM-X--B--o-o---BBoBo??o---?XX---X---o----o--oo-oBMoM?o-oB-?X-M-XoB-X-o?-oMMoo-BMBBo----B-M?
T-MBM------o-MXoXooMB-o?--o------??-MB-o----oM?o---oB----?-o--X?--oX-X-----M-?MX-MMM---o-M?-Boo-?oo-o----M---?--oB?--MBoM-oM--o----MX?M-oM--MoX--B?-MB??ooo?o--oo-?MB---oo--Mo-B-oo--Boo-MB-oo----M----o
ooo--BoX-BMM--oM-----oo-o--o--oMM--X-oo?Xo-BM----o---oo?-oo-o-oo?M--o-X-ooo-o-o-Eo--MMo?---o-?-o--Bo-M-B---Eooo-B--Mo-oM-BM---Eo-o--B--?--X--M?-M-o-----BBB-?ooo-?---B--BM---B---X----Bo---BB--?B-oX?-oM
oM-MMo?MXo-B?oBo-XoM-X--?-Moo-B--o-B---------M-M-B-o?B?-oM?o?MoM-o-MMoo-MBX-B?--B-----B-?B-BM---?-oME-?-?--MX--X-X--B--------MM--MoB-o--o-Moo--Mo----XoB-----Boo-------B----?-ooXo-oo-o--o--o------Bo??X
M-Mo-B---o---X---MB------o-B-E-B-M--oooo-o?---o-o---------o---M-?--ooMBM--o?--oo--B--M-----o-o?X--o??o-M-o--MXoE--Xo----MBoE--X---M--o?EX--Xoo-o?o--M-o-B-?M---MXM--B--o-X----X-MM--?o-XoXo----E--X--o-T
----o--o--ooo-o-oo--------ooTB--X----X-X-oo--o-----o----oo-XoX--oo----o-o------T-----o-o----XX------oX-----E-?MX?EooXXo---M?-----oo-X-B?o--X---o--Xo-oX-------o-o----oo--------X-------oX--|o-BX----oo-E
mo--oXo-oo-X------ooo----Xo-|-X--oo-oo-o-ooo-X-o--o-o--o---ooo--X--------oo-oo-|o-----oo--o-o-oo---oXX--o-XM-oX-X?o----o-o-ooo-o--oo--o-o--o------o-o--o-X---o---X|-ooo-----oo-X--oo---o---Xoo--ooo-Xo-?
XXXXXXXXXXXXXXXXXXXXXXXXXXXXXXXXXXXXXXXXXXXXXXXXXXXXXXXXXXXXXXXXXXXXXXXXXXXXXXXXXXXXXXXXXXXXXXXXXXXXXXXXXXXXXXXXXXXXXXXXXXXXXXXXXXXXXXXXXXXXXXXXXXXXXXXXXXXXXXXXXXXXXXXXXXXXXXXXXXXXXXXXXXXXXXXXXXXXXXXX
