|------------------------------------------------------------------------------------------------------------------------------------------------------------------------------------------------------X
E------------------------------------------------------------------------------------------------------------------------------------------------------------------------------------------------------?
T------------------------------------------------------------------------------------------------------------------------------------------------------------------------------------------------------B
M------------------------------------------------------------------------------------------------------------------------------------------------------------------------------------------------------B
M------------------------------------------------------------------------------------------------------------------------------------------------------------------------------------------------------B
X---oo-o-o-oB---o-o-----oBoX--oo-XXoBEo------oo---oo?-oo---o--X-ooX----oo---oM--?M--X-oo----?--o-?o----o--ooM---o--ooMB--Mooo--o--X--o-B-Mo-X---M---B-o-o--?----MoB-o-o--Bo---oo---B-ooo---B-E--oEBo-oo?
M-?------o----o-o-o-o-o-Bo---o-----E-M--o-ooo-?-o--o-oo------o-----o-o-X?---o-o-o---o-------o-X-o--------o--o----o--------oo---o--ooo-oo--oo---o----o--ooo-oo--Bo---M-o-o--o-o--o------oX----B-?----oooB
|-o-oo---o--o-?-Bo---o---o-X-----MMXXoo-M----------?B---o-o----o-o--M-----------------------o-o-------o-oXM--o-o--M--o--o--oo----oo-o---o--B--MX-o----o--o--o-o-Bo-o-oE---o---o---o--oEoo------------oov
B-o---o--o----o--o-oo----oo-E----o-o-------o--Bo------?-?-Mo-ooo---------o---B--------o--o-E--o------X--oo--o----o----oE-Mo-o-oo----oB---MM-----?B-o-oo--B-ooMoo-B?-M?BXo---o-----oo--B-X----o---o----oB
T-o----o---X-Mo-o---o---o-------o----oo-------o-B--oo--------oo-----?B---o---o--X--?-o---o?---------o-o-ooo-o-o--------X------oo--o-o---o-oo-------o-o-o--oo-o-M-o-------o------o--Bo---Mo-EBoX-o------E
Mo--o----o------o-o----ooo------o--o-o-M---o------oo--o----o------oo----B----oo---------o--E-----o--oo---o-o-o-o-o--ooo---M---oo----o-ooo-o---o-----o--X-o-o---------Bo--o--oo--o------M-o-------o--o--E
M-------?----MBo-o--o--o-o-----o-X-X---o--o---------o----Xoo--B---o-----o-o---ooo-oo---M-X--Mo-o------------B-o--o-B----oooM-----oo--o?--oo--E---o-MB--oBo-X-o-oo----------o-E--?oo------B-------X-----B
B-----------o-o------o------?------o---o--o------ooBB--oX---o--------o---?---o--o--Bo---o--o----o?---B----o----o--oo----o----E--o-----o--E--?XX---o--o-?----o--o-o---------ooMo---XXo-ooo---o---o-M--o-X
---o--o-oooo--oo-o---------o-----oo--o-----o-------oo-oo-o---Xo-o--------oo------o-----E--------o-----oooo--oo---------o---XoMoooo-oo---o?-o------------X---o--o-----o----o-o--oo-----Xooo-----------o-T
mo-oooo-oooo----oo-ooX-oX--o--oo-Xo---oo--ooXo--oX--------o---o---Xo-oo-o---o--o--o-o-M?-o-ooo-E-o--o--o-o---o-oo--o--o-o--oooo-----ooo----oXoooo--X--o--oo-o-XoooX-o-oo--ooo---o-o-oooo--o----o-o-----T
XXXXXXXXXXXXXXXXXXXXXXXXXXXXXXXXXXXXXXXXXXXXXXXXXXXXXXXXXXXXXXXXXXXXXXXXXXXXXXXXXXXXXXXXXXXXXXXXXXXXXXXXXXXXXXXXXXXXXXXXXXXXXXXXXXXXXXXXXXXXXXXXXXXXXXXXXXXXXXXXXXXXXXXXXXXXXXXXXXXXXXXXXXXXXXXXXXXXXXXX
