|------------------------------------------------------------------------------------------------------------------------------------------------------------------------------------------------------o
X------------------------------------------------------------------------------------------------------------------------------------------------------------------------------------------------------X
?------------------------------------------------------------------------------------------------------------------------------------------------------------------------------------------------------B
E------------------------------------------------------------------------------------------------------------------------------------------------------------------------------------------------------M
B------------------------------------------------------------------------------------------------------------------------------------------------------------------------------------------------------T
X-B-B--B-Mo-o?-MMBM--M-oX-B-Xoooo--BoB-?-E-B-?--M?--M?B?-----oo?B-B-M?B-ooX-??M?ooo-Bo--?-oM-?-?BBo-?Mo-XoBM-o-?--XXX-o--?o-ooMM??ooE?oX-oXMXBo-o--?B-E-Boo-XoooBoX--Mo?B?-?-|-MoX-M-BM?MoB?-???BE--oB-E
TB-o-?M---??M-------o--X-o--XM-X--o-M--BXB?-X-?---------o-?XooX----M------XB----E-Bo---?--X---M---Xo---oBB--ooX-M?-M---MB-MoXB----ME?-oo--X-B-?--??---Mo-Xo-X-M----Mo-B---M-MXB-BM--o----o--o----X-|?-o-
---X----oM--------X?M?oB-MBMM---XBX--MXXX?X-oX-B--ooXXo-X|--??---E--oB??-o--B-BXXM-E-o-----BM---?-o?M?B-MBM-------X-o-o--M-MM-BB-?MBM??-X-?o---?X----B-Moo-oB---B------MX----?----MoX---M?---o-o--XX-o-v
|--oB-o---MMX-X-XXX---o-------B?--oM---o-X?BBXB--XMMM-B-BX-X--MX???-B---?MoM-?--?-?B-Xo--oE---o--o-------?M--ooMB--o--o-B-X------------o?--?-?--?-o-X-o-?o-B-o----B-oM---??B---M-X-XB----BB?M--X-?XX?M-|
E?oB--o-MB--M-?o?----M--o-X-BX--o-----oo-?---B-ooB-----o--ooX--M-M?o------o-B-------o??o-XMBX-X-MX-o-M-MX---o?X--o-o-MBB----Bo--?o-?M-Eo-|o-?-XX---BBE?--TB-B---MX-oo--oo-X?--M--X-B-?M?XXXB?o?-X--o---M
|-M----M-----B-M--?-?-X-X-----XoBo-B?-B-B-??--M-M-XM-MoE--XXM-o-B--XooMBM--X-----MXMo--B--?--Xo---?---M-Xo--o-------o-----oB-?--------B?-X-o-oX?o?B-MM---X---?X?----?XoBX---o--BoB--E--B-M?Bo--o---oB-B?
-?--BB--M-?-M-M--M------B-MXooMB-o?----M----?--------BM?M--M-MM--E--?X---o?XXE--?-------o--?-?MM----B--BM??oBM-BooooX-M-X-?----oEBX--M----Mo-B---o-E?-X--oX-?-B-o-BM-XB-o-M-Bo----?BXMo-B---XMMMX--o---M
M--M---------B--------X-----X---o--?XoB-BoX--BM--BMBX--X-MB-o--?XXX?-Bo-o--XBMoX-XoXoBo-XBB-T-oEMBoB-|-----B-?--M?-B-M-XX-----?XB-ooE-?XBo--o-XM?X?M----o-X----XM?--o---M--M-XoBo-M-?oMo--MM----oXoMMXXE
|---BX-B-oo-?X-?--?-------oB-o-----o-E---?oXo--oB---?Xo----?--?--??-?--o-o-B--?o-oBB--X-----|?M?--o-oXo---?----E----B-?oB-oo----B-B-M--X--BBXB-B-o----Bo-----------?X-Bo----?---X------o----T?E??o?---B|
m--X-o?-o??--oo-oo--o-oBB---o--ooX-???X?B-BoXXoo--|X--o-??o-B---B----X--B?-----ooB--oo-T?X-BX---??X---B-B?--?-oBo?X?-----o??-?-X-o--B|-Bo-----o--X??XX-oXB-BB||XBoo-o?-oooB?-o-X?-?-Xo-Bo-X-|??----X-?-o
XXXXXX--X--X-XXXXXXXXXX--XX-XXXXXXX-XXX--X-XXXXXXXXXXXXX--XX-XXX-XXXXXXX--XX-XXXX-XXXXXX-XX-X-XX--XXXX-X--XX-XXXX-X-XX-XXX--X-XX-XXX-XX-XXXXXXXXXXXXXXXXX-X--XXX-XX-X-XXXX---XXX-X-XXXX-XXXXX-XXXXXX--XX
