--------------------------------------------------------------------------------------------------------------------------------------------------------------------------------------------------------
--------------------------------------------------------------------------------------------------------------------------------------------------------------------------------------------------------
--------------------------------------------------------------------------------------------------------------------------------------------------------------------------------------------------------
--------------------------------------------------------------------------------------------------------------------------------------------------------------------------------------------------------
--------------------------------------------------------------------------------------------------------------------------------------------------------------------------------------------------------
-XXM-?oBM-B?oM---BX?---XX----B-??-B-----?--?--E-Mo-M--M-?o-MX?--?MM-?M??-M--?-M-B--M?---?-?-XX-----?-o-MM-o----X---E---B----MB-oMBX-?-M?---?XM--XX---BX-?-BB--M--M?--XoXMXo-M--X-?X--TM-??-B-oB?B?M?----
----?--o--o-M--?----??-?-?BM?-M---oM-M?M-B-o--MooX--o?-BoBXo---?-o-----o?--------------M-----B-oXB--?XB---X?-BXX-ooMM-Bo-M?M--XB---o---oX-M-ooB-?oo---M--B--B--Xo--X-BMo-B?--M----M--|-?-o--XB-o------?-
-M----MX-X--o-X--oMX------o--?----B---o-----M--XB-----M---MX-M----X-X?M-------TBo---B-M--X-----BB-?----?--o---?--MoX---MBo---??---MB?M-ME-o-B-oB--XXXM-X-oM--?-XX---X--X-o----?BXM---XX-X-M--M-B-B--B--v
-------B---X-?-M----M--oX--M--?XB---?--?-----XM-oXMM-Bo-------B-X-M---o-----B-|-?M---?-B--BM?B--o-oX?-X-M?--Boo-M-X----o---M----?o----?MM----B-----?----o--M-----M-B----?MBX--o-M--X-----oo---?---B----f
--X--M--?-Xo?----M----B?M-----o-oo-X----X-?M---?--o----M-----M---M-B-?---M-Xo-Xo--M------Mo---BBX--Mo-?M-o---X-X--?--?B?------E-oB-X--?XMB-Xo-?B-BX----MBM-o??-X--?o-----o--B-?---B---??-B-?------oX-X-f
--X------B??--?---X?-----?B--MX--X-M-oX-----BX--BX--B------o----?-B---?-?-BB-X-M-M--??--?o-M---oX-Boo-----B--?--B--?---oB-B--?MM---MX----?-oB--o--B---Xo-o-------B--MB-M---------M-MX--------BX-?--X--?f
-?----o?M----B--?MMoB-------BoX?-B?-MB-?------X-o?-B-XB---M-?XM-----X-----o--M--?-XX-------o-----B----M-------X--------Xo?-------M----BM---?--?M--oXXM-----Bo--?ooX-o---M?-BBoX-?---M--X-B--?-?X-B-XBMof
-o-o-XX--BM?X-X-o----BE---o---?---o--oM-XBX?-?M--o---?o-XMo----B-?-?------o-B-?ooX-?---------M---o-M-X---M--Mo?X-E-?-XBBoo--MM-BMo-X-------------------BX?--X---B-?---B-ooX---?--X-----?-o----o-B--M--?f
---------------X-----oM-X-------------------X--X---------------o------X----X------X-X--X-X---------------o---o--?B--o--------oEo---T----E--X---X-X-E------------o-o--oo------------o----X---o------o---f
m------o----o-X-o-T----X---Xo-o-----X-XX--------X-oo-------------o------------o-X----------X-----------X--X--X----o-X----X---?XX-X-|----BXX------XX?-------------X-X------------X--XB-----------X------X
XXXX-XXXXXXX-XXXXXXXXXXXX--XX--XXX-XXXX-XX-X-X--XX-X--XXXXXXXXX--XX-XXXXX--XXXX--XX-XXX-X-XX--X-XXX--X-XXXX-XX-XXXXXXXX-XXXXXX-X-XXX-X-XXXXX-XXXX--X--XXXXXXX-X--XXX--XXXXXXX-XX-XXXXXXXX-X--XXX-X--X--X
