--------------------------------------------------------------------------------------------------------------------------------------------------------------------------------------------------------
--------------------------------------------------------------------------------------------------------------------------------------------------------------------------------------------------------
--------------------------------------------------------------------------------------------------------------------------------------------------------------------------------------------------------
--------------------------------------------------------------------------------------------------------------------------------------------------------------------------------------------------------
--------------------------------------------------------------------------------------------------------------------------------------------------------------------------------------------------------
-XXM-?-BM-B?-M---BX?---XX---oB-??-B-----?--?----M--M--M-?--MX?-o?MM-?M??-M--?-MoB--M?---?o?-XX---------MM-o----X-------B-o--MBo-MBX-?oM?---?XM--XX---BX-?-BB--M--M?--X-XMX--M--Xo?X--TM-??-B--B?B?M?----
----?-----o--o-?----??-?-?BM?-M----M-M?M-B-------B---?-B-BX----?-------o?---o--o----o--M-B---B-oXB--?XBo--M?-BXXooo-M-B--M?Mo-B------Bo-X-M---Bo?-o--oM--B--B--X---X-----Xo--M-BM-M--|o?----o---------?-
-M----MMMX----Xo--MX---------?----Bo---o---XM--XB-----M---MXEX----X-XBM-------TB----B-M--o---o-?B-?----?-----o?--M-X---MBoo-X?-M--MB---ME---X--B-MM?X--X--M--?-XX-o-X-?X--XE--?BXMo--XXoX-XMMX-B-?--B-ov
---o-------X-?-M----M---X--M-o?XB---?-o?o----XM--XMM-B----MB?XB-X-M--o--?---B-|-oM---?-B-oBM?B-----X?-X-M?--B---MoX--------M----?--o--?-M---XBo-o----?-----M-----M?B----?-BB--o-M--X----o-----?---B----f
-?BB-M--?-XE?--o-M-o----M--o-----o-X--M-X-?M-o-?-------M---M-M---M-B-?--oM-X--X-XoM------M-o--BBX--M--?Mo----X-X-E?XB?B?---o--E--B-X--oB-X-X?-XB-BX---oM-M--MX-X--o-o---o-o-B-?---B---?BB--?-------X-X-f
-oX------X??--?---XMB----?B--MXX-M-M------o-BX--BXo-Bo-------o--?oB---?-?-BB-XE--Bo-??--?o-MB---X-Mo?-----B--?--MM-?----XBM-?MBM---MX----?-o----o-B---X----------Bo-XB-M--?-o?o--M-MX-oo---o-BX-?--X--?f
-?-----?M----B--?-M-------o-B-X?--?-MB-?------X--?XB-XB---M-?XMo----X-o-o----M???-XX----o-------E-----M------oX-o-Mo---XB--------M----BM---Mo-?MB--XXM-----B---?o-------M?-M--Xo?---M--X-B--?-?XoB-XBM-f
---EM-E-oXE-B-X--?---B-----o-o?--o---oM-XBX?-?M-o--o-?--XM-----B-?-?----E---B-?----?---------M--MM---X---ME-M-?XB--?-XBB-o--MM-BM--X---o-oE------------BX?-------o?---B-o-X-M-?M-XM----?----o---B--M---f
--BM--M---B-o--X-----o--XE-B-X--------o-----X--X-o---o----E-------X--oX-?--X------X-X---EM---o-----o-----XM-o-------o-------o-E---oT----oBMX-E-X-M---------------o----o-X------o-------oXooo---------o-f
m---------o---X--------M-MX-----------XX--------X--------??---------X--o--------X-------X--X---o----o--M--X---------X----X----?X-X-|-----oX-??-o-XXo-------------X-X------o-----X---X-----------X------X
XXXX-XXX-XXXXXX-X-X-X--X-XXX-XXXXX-XXXXXXXX--X-X--X-X-X-XXX--XX-XXX--XX-XXXXXXXX--XX--XX-XX--X--X-XXXXXXXX-XXX-X-XXXX-XXXX-X-XXXXXXXXX-XXXXX-XXXX-X-XXXXXX-XX-XXX-XXXXX-XXXX-XXXXXXXXXX--XX--XX-XXX--X-X
