X-------------o----------------------------------------------o------------------------------------------------------------o----------------o----------------------------------------------------------TX
|o------------------------------------------------------o-----o-----------------------------------o---------------------------------------------------------------------------------------------------To
|------------------------------------------------------o--------------------o-------------------o---o----------------------------------------------o----------------o---------------------------------o|
B----------------------------------------o--------------------------------------------------------------------------------------------------------------------------------------------o---------------E-
----------------------------------------------------------------------o-----------------------o-------------------------------------------------------------------------------------------------------XX
oo-----o------MX--X--B-M-oB--?X--?o--B-M---M-o--o--X-Bo----o----XXM--B-E---------?---E---ooX-o--M-M-M--?---oMEo--EMo--?-Mo-B--X--??o--oE--M--X-M-EX----M---o-BM---------------oM-----B-E-----B-oE-----oE
?-X-Eo---E-?E?----EM-XXM-B---o--BMoo?-?--?-Eo--?E--B-----o-----X--o------E---MM-E-----B?--ME--EE-BM?M--B-M?o------EE-----oMB------?--M-E?EEo-BE--------?-o----?X----E--EX-MBE----M----o-XX--M---B?----Eo
?--B--------Bo-X-o-------X----M-B------B------oBB-----E----??---o-?--X-E---------M?-??-------oM-X--B--oB-oB--o-o-------B--B----M--oE---B?BE-B-------o-?-X--M-E--------X---oMM----MEM---------X-X---M-ETv
XX-M--?-o---EX-o--MXoX------M-oE?-BX----oB-M-----XBXM---o----X-E-o-M---X--B--M-----B-X------Xo-BX-M------oE--M?-B---X-X-M?--oB-X---XM-------E---oo-o-B-M--------?-B---------o?------BB----Bo-----oM---TM
Mo----B-Mo---E------EoMB----o-------M--X-M-o---X--M--?------XX----E--B--E-----X-BX-------X?--M?------o-E------B--?E---E-X-E---E--Mo-B?----?-oBM------MM?E-E--o-?-M?------o-EX-E-X-E---B-XB-o-?-M-BX-B-|E
?-B-M--?----X--oo-----X??M?-----Moo--o-o-ME?----oBo-----Mo-B-o---o-B-B-?-------Mo-X---MB---?---EBo---EMXX-B---X---oXB-------o-X--?E-----X?-X--B-o---------X?-----E?--M-o?-o-----o-----o-------X-B-o--o-E
X--oM-XEE-BE----B----o---EE-M----B-----B-BE---X---EBEBB-Mo-o?-X-------B----?o----MX-XM---B--------o--?-Mo?-Xo-E-Xo----EM--?oo----o--E-B--E-X-o----o--oo---o---?-B--M---B?MM-?-?--BBX--?---?--oE---?-BEEX
X-o---------E---B-----B--o---M-Mo-MB---?-------?---Mo----o--o---?---X-M--XX-M---M-------X-oX---X--?Xo--BB-X----?---E-E---X?BMM-X-o-ME-MMX------oM-------X--B-?----?--E?--o---BE----MoX-B---------o-----E
?-X--Xoo-?-----oo------E-ooo----EB----------??X----o---------EBX------oX--X---?-E---Xo---------------oE-o--BEo--o--o----o-----B-?--E-Xo---X--X?--B---?-EB--?------X-?o--X--X--X-B-------o----?---X---X?M
m--------?-Booo-E----?E------o--?-----E?--B---E-----o--X-Eo-E-oXo--??----X-----o-E--o-----o---E-E-E---X---X-BB---o--?o--EE----EB----------o---BoBo-Xoo---?--o------o-----B--o?X-B-----o-B-?X------oE--BT
XXXXXXXXXXXXXXXXXXXXXXXXXXXXXXXXXXXXXXXXXXXXXXXXXXXXXXXXXXXXXXXXXXXXXXXXXXXXXXXXXXXXXXXXXXXXXXXXXXXXXXXXXXXXXXXXXXXXXXXXXXXXXXXXXXXXXXXXXXXXXXXXXXXXXXXXXXXXXXXXXXXXXXXXXXXXXXXXXXXXXXXXXXXXXXXXXXXXXXXX
