?------------------------------------------------------------------------------------------------------------------------------------------------------------------------------------------------------o
-------------------------------------------------------------------------------------------------------------------------------------------------------------------------------------------------------|
o-------------------------------------------------------------------------------------------------------------------------------------------------------------------------------------------------------
-------------------------------------------------------------------------------------------------------------------------------------------------------------------------------------------------------|
T------------------------------------------------------------------------------------------------------------------------------------------------------------------------------------------------------E
M-oMB-----o--oMoBo----B-?oo?M-MoMXoo--B-?---?-B?o--EM???X?-o---oMMXBoooMXXB-?o--o-oBoMo---oB?o-oB-?XEoo-oo--M--BX--B--X--o-BX-ooo?o--M----M?oo-M-??MX--o-Bo-?o--oXM-oBX--?-?-XoM-o--?-ooMMBB-oo-o?o-o-MT
oo--o--BM-X?XX-B-XM--B-o-B?--X--oX-XB-o-oB-B-Mo-oo?M----?--B--B?----XBo-B--B-B??-BB-?-M-XBM---o?-o-?MB?o-X-o--?----o---BXM?--oMM----o--?-o---M?-M---o-oBM-BX-MooBM--M-o-X-o--oXoMM?--XM?-----BoMMo-oBX-E
XMooo-?o----XB---o-M-o-??-o--MEoo?-----MB-B-Xo--o-oo-?oXoM--oX-o---oo-?o--------o----B-oo-----o--oB-B---oMMM-o-Mo-?-M?------o---?--BB-Mo---Mo-oM-oM-?M-o-ooX-ooo------?--M--XMo-o-oXX---B----o---?---?BX
?-M-----Xo--B-o-oo--oX---?BM--MB----o------M?oM-MM-M?-MXX-o--o---?-oM-oM--?o--o-MB-oB---?-XM-X??------B-?---B?M-X--B-oo-o---BBoB-??o---?XX--MXo--oo---oo-oooooMoM?oo-Bo?X-M-XoB-X--X-MMM---B-?o-----B--?
To-BM-o-o----MXo-ooMB-??----B----??-MX-o--o--M-o----o--XB?Bo--X?-ooX-Xo----B-?MX-oMM---ooM?-Bo--?oo-o----M----o-oB?-BMB-M-oM-----o-MX?MooM--M-X--B?-MB??ooo?o?-o--?MB--oooo-M--B-oo-oo-ooXo-o-B---M----o
oo---B-XBo----oM------o-o-----oMM--X-oo?X-oBM----o---oo?oo--o---?M--o-X-oo--o-o-----MMo?---o-?----Bo-M-B-o----o-B-o----MoBM------o-oBoo?E-X--M?oM---oo--BBB-?oooo?---B--BM--oB---Xo--?BXXoBMMM-?B--X?--M
oM-MXo-B-?-B?oB--X-M-o--?-BBX-B--o-B-----E---M-?oB-o?B?-oM?-?-oM---MMoo-MBX-B?----o---Bo?B-BM-o-?-oM--?-?--oX--X---BB--o----oMoo-MoBoo--?-Mo---M-----XoB---ooBoo----o--B----?-ooX-ooo----oo--------B-??X
M-M--B?------X---Xo-M----oo----B-M---ooo-??-----o-----------ooM-o-o-oMBM---?o--o----oM---o----?X-oo--o-M-o--MXo---X-----MBM--o-?o-M--o?EX--Xo---?o--M-o-B-o-o--MXM--B----X----X-MMo-?o-XoXo---oE--X-o--T
--o-o-o----o----ooo---o--o--T-o-X--oEX-X-----o-------------XoXo-oo-o----oo---o-T--X---o-o---XX---oE-oX------ooo-X---XXoo---------oo-X--Xo-oX--o-------Xo---o--o-o----o-o-o-----Xo-Bo-o-oX---o-?M---o-o-E
m---oX-----X-----ooooo---Xoo|-X--oB??B-X-o---Xo---o-oo--o---o---X-----ooooo-oo-|o--o-ooo--o-o-oo-??oXX--o-M---X---o--ooooooX---o--oo----o-o-------o-o-o-oX-o-----X|--o------oo-X-ooo---oX--oo---ooo-Xo-?
XXXXXXXXXXXXXXXXXXXXXXXXXXXXXXXXXXXXXXXXXXXXXXXXXXXXXXXXXXXXXXXXXXXXXXXXXXXXXXXXXXXXXXXXXXXXXXXXXXXXXXXXXXXXXXXXXXXXXXXXXXXXXXXXXXXXXXXXXXXXXXXXXXXXXXXXXXXXXXXXXXXXXXXXXXXXXXXXXXXXXXXXXXXXXXXXXXXXXXXX
