?------------------------------------------------------------------------------------------------------------------------------------------------------------------------------------------------------o
-------------------------------------------------------------------------------------------------------------------------------------------------------------------------------------------------------|
o-------------------------------------------------------------------------------------------------------------------------------------------------------------------------------------------------------
-------------------------------------------------------------------------------------------------------------------------------------------------------------------------------------------------------|
T------------------------------------------------------------------------------------------------------------------------------------------------------------------------------------------------------E
M-oMB---oEo--oM-B-----B-?oo?M-M-MXoo--B-?---?-B?----M???X?-o---oMMXBoooMXXB-?o--o-oB-Mo----B?o-oB-?X-oo-ooo-M--BX--B--X--o-BX-ooo?-o-M---oM?-o-M-??MX--o-Bo-?o--oXM-oBX--?o?-XoM-o--?-ooMMBB-oo-o?o-ooMT
oo-----BMMX?XX-o-XM--BoooB?o-X---X-XB----B-BoM-ooo?-o---?--B--B?----XBooB--B-B??-BB-?-M-XM----o?oo-?EB?o-X----?o-------B-M?--oMM---Xo--?-M---M?-M---o--BM-BXoMooBMo-M-o-X-o--oX-MM?-oXM?-----BoMMo-oBX-E
XM-oo-?-o---X?X--o-M---??----Mooo?-----MB-B-X---o-ooo?oX-M---X---oooo-?o--------o-o--B-o--X---oo-XBo----oMXo-ooMo-?-M?------o-o-?--BB-M-o--M---M-oMo?M---o-X--Xoo---o-?--M-X?XM--o-XX---B--------?oB-?-v
T-------Xo--B---oo--oB-o-?BM?-BX---oo-o---oM?oo-MM-BX-MXM-o--oo--?-oM--M--?-oooXM-ooBooo?-XM-X??--o-X-B-?-B?-XM-X--Bo-o-o---BB-B-??o---?XX-o-X---o----o--oo-ooMoM?o--Bo?XoMo-oo-X--?--Mo---B-?o--o--B-M?
ToMBM--------MXo?ooMB-??--o-B----??BX??o-----M?o----B--X-M?X--X?-ooX-Xooo-oo-?MXoMMM---o-M?-Bo--?oo-o-o--M-o--o-oBX-M?--M-oM--o----MX?M-oM--MoX--B?-MB??ooo?o--o--?MB--ooo--M--B-oo-o---oXo-o-----M-o--o
ooo--B-X-o--o-oM--------o---o-oMM-oo-o-?X--BM----o---oo?o---o-o-?Mo-o-X-ooo--o---o--MMo?o--o-?o---Bo-M-B----o-ooB--oo--M-BMo-----o-oB--?--X--M?-M-o---o-BBB-?-oo-?o--B--BM---B-o-X---?Bo--BMB?-?B-oX?--M
oM?MX--B-?-B?oB-oX-?-oo-?-Mo--B--o-B-o--oo---Mo?-B-o?B?-oM?-?MoM-oXMMoo-MBX-B?-o--o-ooB-?BoBM-o-?--M--?-?--oX--XoX-BB--------M---MoB-o--o-Mo---M-----XoB-----Boo-------B----MoXoX--oo-o-oo---o---X-Bo??X
M--o-B-----o-X---X--M---oo-BoE-B-M---oooBB?--o-oo----o-o------M-M----MBM---?o-ooo-o--Mo-------?X--o--ooM-o--MXo---X-----MXXBB-X---Mo-o?----X----?o-EMoo-B---o--MXMo-B-o--X----X-MMo-?o-X-Xo---??--X-o--T
-o-oo-o----o-----oo--------MMXM-X----XoX-----o-----o-------XoX---o---o--oo-----T--X-----o---XX--o---oX-o--------XE--XXoo-ooo----o---X---o--X-o----X?--X-------o---Xo--X-o-Eoo-oX--M----oX-o---------oo-E
?o-BoX---o-X---o--ooo-oo-Xo-o-X--oo--o-X-o-ooXo---oooo--o--oo-o-X--Xoo---oo-oo-|o-----oo-oo-o-oo---oXX--o----oX-B?o----o-o-X|--o--oo----o-------o-o-o----X-oo----X---ooo--o-oo-X--oo---oXXXoo---oo--Xo-?
XXXXXXXXXXXXXXXXXXXXXXXXXXXXXXXXXXXXXXXXXXXXXXXXXXXXXXXXXXXXXXXXXXXXXXXXXXXXXXXXXXXXXXXXXXXXXXXXXXXXXXXXXXXXXXXXXXXXXXXXXXXXXXXXXXXXXXXXXXXXXXXXXXXXXXXXXXXXXXXXXXXXXXXXXXXXXXXXXXXXXXXXXXXXXXXXXXXXXXXX
