-----------------------------------------M-------------------------------------------------------------------------o-------------o----------------------------------------------------------------------
-----------------------------------------------------------------o--------------------------------------------------------------------------------------------------------------------------------------
--------------------------------------------------------------------------------------------------------------------------------------------------------------------------------------------------------
--------------------------------------------------------------------------------------------------------------------------------------------------------------------------------------------------------
------------------------------------------------------------------------------------------------M-----------------------------------------------------------------------------------------------------o-
---o?oM-E---o---------?-?B-MM-B---?oB-------B-----B--M-----X--------E--X-----B----X--B----oo?oo---o-?oBM?M?X---?Bo---o--B---M-E?Xo-EMM----?------XE--B-B--oB----?-o--B-BE---------BX--?M------X-----M-o-
-Bo----M?--?----o-?-------o------X-B----?-B--X-B------X-------X---X?M?----Mo--EEo---X--------MX-o?o-----o--EB-X--MX----------XM---M---?-E--M----MBXB-----?E--M----M-----MM-------B--o-oo-------------E?-
---?----o--oo---M--??----XB------o-o-?-----------X---------------?--X--oM-o--XBX----o----------------o-M-------------------oB--B--o-E---B-----E------M-E-BB----o--o?-BX--o--------BBX--------X-o---?XX-v
-?------?----Eo---B-------o-----o-M---MX---B--?-------------B-BX----X--------X---M--M-X-----------BBB---o--o------X--?---------o-M-B---------B?----B--M?------M--?oo-----M-X------o-o-o?----oB-?-o--oo-f
-------?---???-?B---o---o------MM?---oo----o-M-?--o-------?----B-BB--MB-M?X-B-XB---B--------B----?o---ooB----?-o-B-o---B-?------M-MoMB-X---------B-------E-------o-o------oX-XX----------?-----oXE-----f
--M--B--B----o-oo----B----o-o----ooB?X--E--------XM---o-----o------XX---o---o--X?M--X-o-------oM--T-----o--?---M?o-?-Bo----X----o------oM------------X-B??------E--M-B---------------X----?M-----o-?--Xf
-------------?------------o---B---o------B-----?-X----M--?--B?o?-------?------X-oo---BX--?---M----|-BB-M--------o-----ME---B-o-o----------M-----B-B-----------B-oM----X-----EB----E----o-o--X--B-------f
-o?--EB--B--E-E-X-------------------B--X----------o-------o--------E----X----Bo---Xo-------------BX---B-MBoEM------M---Xo------------------?----oX---XMX--------M---X------X?----MX----B?--X-?-oXM?XE--f
------o---?XM?Mo--------------------o----o---X--o-----oX----MM----?BE---o-o--------------o-------o--o-o-o-X?-----o------o---------E----o--------------------------------X---------B----------o----MXMB-f
m------o----o------X----o--------------o-T---X-----oX--o-o----o-----?o----------oo-----------------?------------o?MX--o---o-------?---oX-----X---X-oM-------------X-------------o------o------o--------X
XXXXX-XXX-XXXXXXX-X--XX--X--XXXXX--X-XXX-XX-XXXX-XX-X-X-XXXXXX-XXXXXXXXX-XX--X--XX-XX--XXXXX-X-X--XXXXXXX--XXXXXXXXXXXX-XXX--XXXXXXXXXX-XXXX-XXX-XX-XX--XXXXXX-XXX-X-X-XX--X-XX--XXX-X--X-XXXX--XX--XXXX
