T----------------------------------------------------------------------------------------------------------------------------------------------------------------------------------------------o------?X
o--------------------------------------------------------------------------------------------------o-------o------------------------------------------------------------------------------------------XB
|-------------------------------o-------------------------------------------------------------------------------------------------------------------------------------o-----------------------o-------?E
|-----------------------------------------------------------------------------------o----------------------------------------------------------------------------------------------------o------------?T
B----o-------------------------------------------------o-o-------------------------------o---------o--------------------------------o-----------------------------------------------------------------|?
----B-o-----E-B-o---------M-M-X-------oB---X-XM--XM-BMX-o---?-EE----MM---?X--?---X-oB--??-E-o-----B--Bo-Xo--ooMM--M-Eoo---M---ME--Xo-------X--E--B-B----Xo-B-X-?--ooo---X--B-?BX-o--M----?--E-----B-M-XT
o-MMX---BBB-oX---E---??-Mo--o---o---E--------?-o---E-E----X-Mo?--o---oX---XBBoEM-----BE-----o--M-o--BM-o--M--o------------B?----M--B-o?--o-o----B---------E-oB-MEo-B-o--X-M-----o-B---M------M?ME?----E?
B-----?--Xo------X?-X------E---MXE-oE------B?-?M-------B--o---M-X--?---B-o-E?--X---B??--??o-?M--EB-o?o-------o--EM-o----M----M-------o------------X-Bo-M-E?----EE-------o-M-?-E-?---E-B-EE?-----B--X--Mv
B-B---E?B?o---o-?---o---BB--B---o--o-o---EMX-oM--X----?--B-B---o--------E-----MEXo-??------Bo---oE---MEXBE-------oEX----M-M----B---X--?X-o--X---?oB----o?--o--X----E---X------E------X--X----------XX--X
o---o---EX-----E-----XMM-o-E-oo?-------M-----o--M?-E-E----?ooE?-----?--XXo--E--o-o-B-----B--E-oM----M------ooBE---?B--M------E-E--B-E-o-BXXX------?M---?-M-E--E---BB--?M---Xoo--o---EE-----X-------E--oX
|--E--E---oX---?----EoMM-oXEEXE--o----M-----?Xo---o-?-X---o----M-?--X-----Xo------oMo------M--B--?-o-------o-------?Mo----------X------E--E--M-M?--oX--?----o---X-?--B?-XX--?-------E---o-MMB---X--X--MM
X--?---XoX?o-------------BB-B--B-B-E-B-o-EEo-o--?---E-M-?-BE---EB-o---oXo--oEo----MM--?-Moo----oo---B-?--M-M-X-----?o----------B--o-o-X---X-B--?--?--------------E--------B--o---?-oX-o-E--E-M---BM--M|M
o-E---M--o--B---oEEM-------BMEMo-----E--o?ooo--E--B-o-??----EB---------M---oo--MoB----B--XX-----XBE---M-E-o-B-MX--M-BE-X--M-M--Mo?--M--M-o---X?-XE----E---BEB--o--E-oBX-------?-E-XX?--MB--ME--E---oo--X
MB--X-X---Xo--oEBXo------B--?-?---E---X-----------E-o--E-----B--B-?---oBBE-o---E----Bo-ooE-o------B-oE------?E--E-----o??-----EEEo----XE---o----X-oB----------------X----X-----EXoo--B?---E---?-X-----?-
mo-----o-----E-B---X-ooEX-?E-----XoB---------o---?-----E------E?B?o-----o-?-XE-?--?---XE?---E---------o-X---------o-E-B-----?E--------B-BB-B---?-?--------B--B----X--Eo-B-B--------B--oE-----B-?-o----X|
XXXXXXXXXXXXXXXXXXXXXXXXXXXXXXXXXXXXXXXXXXXXXXXXXXXXXXXXXXXXXXXXXXXXXXXXXXXXXXXXXXXXXXXXXXXXXXXXXXXXXXXXXXXXXXXXXXXXXXXXXXXXXXXXXXXXXXXXXXXXXXXXXXXXXXXXXXXXXXXXXXXXXXXXXXXXXXXXXXXXXXXXXXXXXXXXXXXXXXXX
