---------o---------------------------------X-----------------------------------------------X--------------------------------------X-----------------o------------------------o--------------X-----------
--------------------o------------------------------------------------------------------------------------------------------------------M----------------o------------------X-----------------------M----
--o---------------------------------------X----------------------------------o------o-------------o-------M------o-----------o-------------------------------o------------------------------------------
-------------------------------------------------------o----------------o----------o---------------o-------------X-------------------------------o------------------------------------------------------
----------------------------------------------------------------------------------------o----------X------------------------------o------------------------------------o-M------------------------------
---MX-o---MM?Xo?M?MoM-?X--?X?BMM-Bo--X---oMo??-Bo?X??o-?XBX---XMo-?--M----?----?B?--XX-BBX-??o---XB?--M-BBXX?B-X-?X--X---B---X?M--X--o----?X-B---X?X--?MMX-B---Xo-?---B-X-----BB-MM-M-B-?XXB---MX----MM-
------XoX----------ooo---BoB-o--?----?XM-Bo---?o-----MB-To--X-?-?------o-B--o?-o-o?--MB--------XBo-o-BoB---Bo-B--o-MBX-oB-B--X-M--o-MB-B-X----X?B-o?o----MXo-o--X--oo----?MBMX---------?--?-o-----B?o---
-o?--------M-?-XM-Mo---MX--o?---o??--oo-X--o----oBoo---X|X------o--X--BBMo--B--MM?-?----BXB---o--MM---X--?--??-XXX----------BMM---XX---o-M--o-M-----M?BM-XMBXXBE---MB---M--oo---X?-Mo----X--M----B-oMBXv
-M--?oMX----XM-X---?-o---BM-oX-B---M--o----X?-B-Boo-----X--BXBX--X--X--------XX---BoXXX------?B-----B-X??-X?---oBo--?XX--BM-o---oB?B-----oM---o---T?-o---Xo-MM?XBB---B-?--?XBo-oB-M-?---BM-?-?--?---o--f
-----M----B?-MMMo-?---BB-o--?X-----o-ooB-----?-----X---EB-----?---M-o-B--MBX-XMMXM--?-??-?--X--?-XMo-----?o--M-Bo-oo-M-M-----?o-------X--?----o--X|-X-B?MB---M--M--?--?------M---M---?XM-?-----Bo?-M-X-f
-XBo---MB---M---o-oB---------X?BMM?---?o-?-?M--M??---??----XX-----XMMo-BXo--o?----X-----X-?-?--o---?---E--MX-o-oXXX-X---------B------BMB---?-MM--?X-o----oo-X----?--XMo-?--?---o-o-B-oB---BBo--o---o-?-f
-?MB-B---BXo----X----o-?B-B-----oo-M---X?---oB--o-M--o-o--XM??--MB-o--------?---o------B-----?MX----XX??MM--X?XMX--X-o---?Xo---o-------o-Mo--oo-B--?BB?-XB-?XBM-M-X-M----Xo-o---------o-----M--EX??----f
------B-?-MX-----M---M-------M--o--o---B--B----XXM--oM--?MEo--------X-X-X-?X----BoX--MMo----?--M-XM-BX-M---M----X-----o------o-o--XB---M--X-X-MM-XX-o--X-o--X----?MBoo----?---oMM?B--M--oo----M?----E-Bf
-----X----o-----------o--M---o-------X----o----------o---oM------T-XT-X-------o-o--------X-------X-X---o-------E---------X--X--M---o-------oo--o---?-------o-o-----------oo---X--o---oXX-----------XoB-f
mo--------o--o-------oX--M--MX---------M--o--X-o-------------X-X--X-|----o----X---o-o---Xoo-oX--------o----X-XBB--X-XX-----XX--X-----X-----X-o--X-X--------------X-------------X------------oo---XX----X
XXXXX-XX-X-XXXX-XX-X--X-XXM-XX-XXXXXXX-XXXX--X--X--XX-XXX-X-XXX--XX-XXXXXM-X-XXXX--XX-XXXX-XXXXX--XX--XX--XXXX--X--XXXXXXX---XXXXXX--XX-XXX-X-XX-XX--XXXX-XXXX-XXXXXXX--XX--X-XXX--XX-X-X-MX--XX---XXX-X
