--------------------------------------------------------------------------------------------------------------------------------------------------------------------------------------------------------
-----------------------------------------------------------------------------------------------------------------------------------------o------------------------------------------------o-------------
--------X--------------------------------------------------------------M------------------X-------------------------------------------------------------------------------------------------------------
-------------o----M------------------------------------------------------------------------------------------M------------------------------------------------------------------------------------------
----------------------------------------o---------------------------------------------------------------------------------o-----------------------------------------------------------------------------
----?---M-BoX--------X--?M?B-M--XTB---BX--X-MBE--MB--M---X---?XB-?B-X------?X---?MM?-MB-B-----oB-o-?--o---B???-M---B-?-?-BMM---X?---M-?---?M---M--BX?-X----BMMX-B?-?-BX-Mo------X--?-X?-?--?M---?---XBX-
-----?-Bo--M----MMBMXB------B---M|--XXo-------M?-------?BB-X--X-?--?----M-B--X?---o----Bo--BX-B-BXX-XMX--------XXBMoB-X--------X-?---?o-X-o-??M-BM--o-M---?o--------X--?-XoM-B-B-BX--MoM-BM--B----------
--------??---?----o---?--B-B--M--X---M-?o?B---M------XM---------o----XXX-Xo--------X?-?o-----B---------MB-MMBMMXXo---M---B--MX--Bo-----B-X---o-?---BX?---XoX------MM-X-oX?M-?-M-?---M-X-M---X-B-M?M-M-?v
-XBB--B-o------?-?B-----------------Xo--X---M----M-X?BMX--XX?BMXB-?--?----BX----B--------??B---M--M-BMX-----o--o-MB---?B---M------B---o--B------B?--M-?B?-X----XX--o-------Xo--------??--?--M--Moo---Bof
---------?--BMX-Mo--?-B---oB--------B--------B----oM----MM------o---X---M----?--------M?--oo--?--B-M--B?-?--M-M-----?-o-?-BoM?-----B-----o------oo--o-------?---??--BBB-?----?--Bo--?--?--?Xo-?--B-X---f
-?Xo------B-o-X--------??-M-?-----?--o?-------B---------o------B--?---B---MM--XM-?---B----B--Mo-B-------o--?-B--X--o-M----o---M-o---MB---MBX-M-M----X-B-B-M-oM-X---XM------XM-----?----oE-BXXXo--oB--X-f
-o-X----??-----B---X?----X---B-o---------X-M?----?-MMM-M--------B--o--------M-X--o--o----M---o-X--B-BM-?---o--M-?MXB--?M?-------------M?--o-B------XM-o--?----?M--X--M---X?Bo-M-?o-M-M-MMM----B-----B--f
---M--M----?----X--?-X-----X--BX-X-----M----o-----o-----?X-XMM?----X--M--------?-MXBB--?------B-------X-MX?----B-------o----X?-?----M---?B---o---?X--B-------------MX----Bo---o----------o-----X---M--Xf
------------T-----X------------------X----------o-----XX---------------X-------o-----------oX----o--------o----o---------------o-X------------X-------X------------o--X------XX-------o---o------------f
m-----------|X--X----X------------o---X----o---X------X----XX--------X-X----XX--------------------------------------X-----X-----------X------X----X-----o-X-----------------X---X-X---B--X-------------X
XXXX--XXX-XXXXXXXXX-X-XX-X-XX-XXXX-X-XXX-X--XX-X-X--XXXX--XX-XXX-X-XX-XXXXXXXXXX--XX-XXXXXX-XXXXXX-X-XXX-XXXXX-XX--XXXXXXXX-XX--X-X-XXXXXXXXX-XX-XXXXXoXXX--oXX-XXX--X-XXXXXX-XX-X--XXX--X-XX-XXXXX--X-X
