T-------------------------------------------------------------------------------------------------------------------------------------------------------------------------------------------------------
X------------------------------------------------------------------------------------------------------------------------------------------------------------------------------------------------------?
M------------------------------------------------------------------------------------------------------------------------------------------------------------------------------------------------------?
X------------------------------------------------------------------------------------------------------------------------------------------------------------------------------------------------------|
|------------------------------------------------------------------------------------------------------------------------------------------------------------------------------------------------------B
XBoE?-?-oM-BB--M?M-BMXB-B---?Mo----?o?MB?--oBMXEoXo-MoB?o?XB-B------M-X?-o-B?B-?T-XBB-BMEooX-M-XXoM?-?o-XMoBB-o?M-XB-o-M-?-MBoB?Bo-XBEo---?o?--M-M-BoMoBo?BXoo-X-M--BXo-Xo?B???-Xo---?o-?-B?B-M?Mo--MM-T
---X-?--B----oo---?----B--M?--?X--B-M----o-X--BM---M-o--M-M-o-B-oB-o-----M------|o---BMBBXXBo-oM?---T--------M---oo-o-?---o--X---X?oXXo?---B--o-----?-o-?---M??-M----XBE-X-----BBB--M-?B---------?-M--?T
M--B---X--Xo-EM-Xo---o-------o-oo--X-o-X?X-EB-B?o?o--M---o-oB-----MBoMMBo---BB--XMXM?-oMB---?BB-----|?o?o-o-?-XoM-X-?---o-BBE-o------Bo-o-----XB--o--B-----o---o--MB---XX?M-Eo----M?----X?M--oo---M-M--v
M----o-M--oMM?-o?M-o?BX-BoXB--o-BMBBXB-Bo??X------E---BB-?B----M-B--o---BBoX--?-o-X--??---Eo-----o--X-oBBBMB--BX-oMo-?-Boo?BMM?-XB-oo-M-M-X-oMo-M-oBX-?B-BXM?--Xo----o--Mo-BX?---X--BoE----?-MoX-?-M-X?|
M-X-oo----B--MM-X??M-----oo-M-BX---?--M-MM-B-Bo-BBM-?---B---o-o-?M-----X--X--B----XE-----?M?o??B--B----o-----o---?-X-----o-BMo-Bo------o-?-------Eo-oM----B----o---M-XBM-?-o---MM----MX--Xo-o-oX------E|
B??o?---?M-E-Bo------ooo-??--o-MMoo-M--B---o--X?--?--B-X-?--B-M---o-X?-Mo--M---X--?MoB-B--o-X---XX----X-X-X--XoBo-XMMMBo-B?--B----E??-BXB--B--M?BM-oM---Mo--E-MM----B-----oXBM-----Bo----MB-oEoM--oX-MBT
M--M-M---BB??-Mo?o-BMMXX-----M---XB?------?EM--MB---T--BX----o-BooMMB-o-M-M-o--?Mo----B----X?B-------B-XX?-------?o----?T--o--?oBMB----o-----o--X?B---XM-M-XMM--o-?---??o-M------oo-?-MB?--M?B?--X?B?-oX
Xo----?B?--M-M-M-oM---B?BXBo--o?-BXoB-?o---?-----?BX|MX--Bo-BB--MB-B--M--?--XEo----oo-----oB---M--------B-BB-?EXX-B--XX-X--X-M-BMBXM-?-?X-To-o--o--M--o---oBB-MXE----o--X--B-----?M--M----M--BXXXX---o?T
TB--------X-|---X--o-------BB-?--o---B-o--oMX---o--?X-X-B--X---B--o-?---B--BB??---oBBX----B---X-oXo-Xo-?-----?M-?--?-X?Xo-o?o-------?-----|?-?X?X----o--X-X---BM?----?-Bo----Xo-o--?--B-X--oB-XX-X---T-M
m-oBo-o?BBXX|o?Xo?-ooX--B-o--o---B-Bo--X-XXB-o-|BoB-X------B-o--o----o-?---??|?--XB---oooo-X|--oT?-oXo---|o?|?o--X?-BB--X-B-Bo-o--o--?o?oBX---B-?B---X--TXX?--o-o-X-B-o-B-B?o?--X??-BB-oo--o-X-Xoo-oo|-M
X-X-XXX-XXXXXX-XX-XXXXXX-XXXXXXXX-X-XXXXXXX-XXXX-X--XXXXX-X-XXXXXXXXXXX--XXXXX-XXX-X-XXXXXXXXXXXX-XXXXX-XXX-X-XXXX-X---XXX-X-XXXXXX-X-X-X-XXXX----X-XXXXXXXX-XXXXXXX--XX-X--X-XXX--X--XXXXXXXXXXXXXXXXXX
