?-------------------------------------------------------------------------------------------------------------------------------------------------------------------------------------------------------
?------------------------------------------------------------------------------------------------------------------------------------------------------------------------------------------------------?
X------------------------------------------------------------------------------------------------------------------------------------------------------------------------------------------------------|
X------------------------------------------------------------------------------------------------------------------------------------------------------------------------------------------------------X
E-------------------------------------------------------------------------------------------------------------------------------------------------------------------------------------------------------
E-X--XE?oME?MXo-oooX?EE--?XoooX-?M?Mo--o-Xo?--Mo--?XMX-?E?MXEB-oEMEMB-E-EMXBBBX-----E?o--BM-EB-B---B?-BE?M-XMBMoEXMo?X-XXEXo-XBoE-oX-Eoo--XoMEM-BXBMo-MooX?-E-MoX-M-BM-EEXo-oo?XoXEXoo-M?o-oo-EoMMoBoB-o
TMMBM--?BXMBEo-XB-?-??X?oBoBBB??-----EEXM-oo--MXB--EMX---ooBoM-MBB-?--E-??ooo--o-BoB?Moo?X?-----o-o-EoB--oMEXEEo-EoE-------Mo--B?X-oM--X-BMM?XXEoME-E?-o--o?oE-Mo-BBE--o?M---BM-o?XMEo?-M--EXoM--E-Xo--?
--o-XE---oo?oo?BoXo??E-?-?M-XEMME-oB-?Xo-Bo-oBBB?EX?MMBEB?E-?E?---?MXM-XXXoXEMB------Moo--o-ooMEE-E-XMX-X??BBEXBM--EM?--o-B?M-X-MBB---o?o-?B-o-M?E--BMB?oM-X--EXB??B-MMX-BEoE?oX------X-X-oM??BoEMXMoB-v
?B-BEXMBBoBXoX-oXo----oMM--EoB-oXX---BMB-B-BX-M-???MXXE-EB-??--MEooMEMB-?E-M?X?o-ooMoo--MB-XBM?BoMB---BEEoo---BBBo---BXoo-Bo?Bo---Eo-Xooo---?-X-EMB?MM--?-oBEM----XoEX-MEMo-B-X-oEBMBB-?-BBX-?X-B-ME-XX-
|ooBEEM-MEMM-?Bo---M?-oM?o-BMXB-?-B-B?o?EoE-o--XM?-oo-?oE-B--EBEo?-?o-oBB-oXo?MXo-MXXXBM-oX?-E?-o?M-Moo-oEE?o-o-ooM-o-?BEXX--B-EX-o-o-E?oE-X-EooBB-??-EBB?-M-EoB-Xoo--XM-Mo-B---?MMX-B-BoE?M?oE-o-?BMB-M
EB-ooBBXoX-BM?--oEXoM---BBo?XoB-X-oXo--XE-XEX--Moo-E-B?-E?-BMBEX-XoMX?oEB-Xo---ME--EBXXM-B-MX-?XoX----?B--XEX-EXB-o-?E---MB?Xo?X---oB-XX-XM-E?EXXooo?M?BX--BMEEooEMMEo-Mo?EBoBoo-ME-B-?MoBEXME--?E-EX-B-
?--X-BBXEMo---o?--oBoXMooo?-MBBE-MB??ooBEMBB?-M?XE-E-BBBEEBEE?BM?E----?MME-EMoBMo?MX--?B-B---EoMoBXMXXEMoEEEEoX--ME?B--?EEEoX-?--oX-XXo-B-MBXB--B---o-M--oEXBE-oooXMoooo-BEoEEXXMMMooME-o-M--EXoBBo-BMXB
MXB-?oBB-oM-EooB-XX-oXXEBE?Xoo-B--BooBEX-oMB---o-?-oo--oB-X???o-?M-oBo-oBoBoXM--BMXBE?-XEXBMM?o-Xo-MEo-XB-?M?X-BoMoM-?-Xo-M?MooM?-oMXE-ooEEMX?B----oMo?BEEo?-Xo?oMB-BBE-?o-XoX-Xo?MXX-EB-MBMEEBXM--BEBEo
X--oEBB-E--?-X?X-X-B-B-XBXBBX--XX---oooXoXXB-ooEBo---BB?oB?-oXo-XB-?--oo?oo-oB-X-X---B?XXX-Boo-o-EEo-oo--oE-----X-Bo?E?---o----XoEBB-B--oEEBBBoXo??-X?EXB----EB-o--o--???-o-BBX-?EoXoBo--?Bo?---Bo-Xo---
m-E?-oE-B?X?BEX--?----?-?XoB---?--?oXB----BXo-B?XooEooo-EE-B-BoB--oE-o---XE--oo--oXXoXXBB--?o--Eo-Bo-?X-?-----X-?X??----Boo----B?oX-EX-E--oo-??oEBXXooB--B-BE--E-XoEX-X-X---?Bo?-----X-oo?X-E??B--B?-BoT
XXXXXXXXXXXXXXXXXXXXXXXXXXXXXXXXXXXXXXXXXXXXXXXXXXXXXXXXXXXXXXXXXXXXXXXXXXXXXXXXXXXXXXXXXXXXXXXXXXXXXXXXXXXXXXXXXXXXXXXXXXXXXXXXXXXXXXXXXXXXXXXXXXXXXXXXXXXXXXXXXXXXXXXXXXXXXXXXXXXXXXXXXXXXXXXXXXXXXXXX
