----------------------------o---------------------------------------X--------------------o--o----------------------------------------------------X----o-------------------------------------------------
-------M---------------------M-X------------------------------------------------------------------------o--------------------------------------M---o-------------------------------M--------oo----X-----
------------------------------------o-------------------------------------X---------o---------------------------------------o------M-------------------------------------M----------------o---M---------
----------------------------------o-----------------------------------------M------------------------------------------------------o-----------------------o-o--------------------M----M---o------------
-----M--X--o----o---------o-------------------------X-------------------------------------------------X------------------------o----------o-----------------o-------------------------------------------
---MX--o--M-?X-?M?MoM-?MT--X?BMMoBM--XX-?---?--M-?X-?--?XB----XM-oX--M----?----?B?--XB-BB-o??M---XB?--X-BBX-?--XM?X-oX----X---?---M?-E----?X-B---X?X--?MMX-Bo--M-X?---B-X-----BM-XM---B-?-XBo--MX----MM-
--oo--XX----o---X--Mo-o-|B-B----?-o--?XM-BB---?---Mo-MBo----X-?o?--------Bo-oX--o-?---B--------XB----B-B---B--B-o--MBX-o---o---Moo-BX?M--X---oX-B--?-o---MXoX--oX-oX--o-o?MBMX-o-?-----XM-?-?--o-oB?----
-----------M-M-XM-o----MXo-o?--M-??--X-oX-o--o---B-----X-X-------o-?--?--oBM?--Mo?-?----BXB---oX-MM---X--?--??-M-Bo--o-----MBMM-XMX--o---?--?-M---ooo?Bo--MBXXBo---B--o-M-------X--M-----X------o---?--v
-M--?-MX---o--oX---?-X---B---X--o-oM------oX??B-B-?----oXX-BX?M-oX-------?--B-o---B-XXX------MX----MBoX-?-X?----B-BXMX---BMoo------B-----oM--o-X--??--------Mo-MoBXo-B-?--?XB---Bo--?---B--?-?-M?--o---f
----------B?-X-Mo-?---BB----?X-o--o-XBo---?-M------Xo--XBXo---o---o---B---BM-XoMX-----?--?--X-o--XMoo--o-?---M-BoooBM--M-----?----o---X--?o------X--M-B?MBo--M-oM-?--o?-X-o-oM----o--?XM-?----oBo?-MMXBf
--?-o--?B-o-MM-----BB--o-----X-MBM?M-----?-?M--M?--o-----MMoX-----XMB--BXM--X?----X-----X-???----------o-o------XXM-X-o------XBoo----BMB-----MM--?o----o--Bo-X---?--M---?--?---X---B--Bo--B?Bo----o-o--f
-?-BoB---BX-----X------?B-B------o----oX?o-M-B----M---oM----X---XB-----o----o----M--B-XB-----?MX--XBXXXM-MB-X?XMX-oX-----?XX---BB-----o--M--M---B---M-?-XB-B-BM-M-X-M----X--------o----------X--X?o---Xf
----X-BM--MXM----M---ME------B-------o-Bo-B----XXM---M--?M-BXB----o?X-X---?X---------MM-----?--XXXM-BX-oo--M-------B----Bo--o--oo-Xo--BX--XM--MM-XX---o?--o-Xo---?MB----E-?-B-oXM?B--M-------------o--Mf
------o--o------------Mo-----------E-Xoo----------------M?BoE----T--T-X--o-X-----XoE----oX--o---oX--o----X------o------o-X--X--o-?-------------oo---T---EM---o----------B----o?--oo----------ooo---T--of
m-----o-----------oo--XM-----X----XXB-------------------X-MMM?-o-|Xo|-------o------X----X---oX----oo--------------X-XXo----XX--------X----------X-X-|--BM-----------------------------o------Xo--X-|-o-X
XXXX-XXXXXXXXX-X-X-XXX--XXXXoXX-XXXXXX-XXXXXXXXXX-X-X--X--XX-XX-XXX-X-X-XXX-XXX--XXXX-X--oXXXXXoXXXXXXXXXX--XXXX-XXXXX-XXXX-X-X-XX--XXXX-XX--X-XXXXXXXoXXXXX-XXMXXXX-XX-XXX--XXXXX--XX-X--XXoXX-XXXXXX-X
