|------------------------------------------------------------------------------------------------------------------------------------------------------------------------------------------------------o
X------------------------------------------------------------------------------------------------------------------------------------------------------------------------------------------------------X
?------------------------------------------------------------------------------------------------------------------------------------------------------------------------------------------------------B
E------------------------------------------------------------------------------------------------------------------------------------------------------------------------------------------------------M
B------------------------------------------------------------------------------------------------------------------------------------------------------------------------------------------------------T
XoB-B--B-Mo-o?-MMBM--M-oX-B-Xo-ooo-BoBE?o--B-?--M?--M?B?E-----o?B-B-M?B--oX-??M?ooo-Bo--?-oM-?-?BB--?Mo-XoBM-o-?--XXX-o--?o-ooMM??ooE?oX--XMXBo-o--?B---Boo-XoooB-X-oMo?B?-?-|-MoX-M-BM?MoB?-???BE--oB-E
TB-o-?M---??M-------o--X-o--XM-X--o-M-?-o-X-X-?-------XXM??XooX----M------XB----E-Bo---?--X---M---Xo---oBB--ooX-M?-M---MB-MoXB----?XX--o--X-B-?-o??----o-Xo-X-M----M--B---M-MXB-BM--o----o--o----X-|?-o-
---X----oM--------X?M?oB-MBMM---XBX---M-oo--oX-B--ooXXo-X|--??------oB??-o--B-?BXB---oo----BM-----o?M?B---o-------X-o-o--M-MM-BB----???-X-?o---?X----B-Moo-oBE-EB------MX----?----MoX---M?---o-MXX?X-o-v
|--oB-----MMX-X-XXX---o-------B?--oM---o-X?BBoB--XMMM-B-BX-X--Moo--EB---?M-M-?--?-?o-Xo--o----o--o-------?M--ooMB--oE---B-X-------------?--?-?--?-o-X-o-?o-B-?XX--B--M---?oM---M-X-XB-o----E---X-?XX?M-|
E?oB--o-MB--M-?o?----M----X-BX--o-----oo-?---B-ooB-----o--ooX--M-MMM------o-B-------o??o-ooBX-X-MX-o-M-MX---o?X----oXMBB----Bo--?o-?M-Eo-|o-?-XX---BBE?--oB-B---MX-oo--oo-X?--M--X-B-?-X--XB-o?-X--o---M
|-M----M-----B-M--?-?-X-X-----XoB--B?-B-B-??o-M-M-XM-Mo---XXM-o-B--XooMBM--X---E-MXMo--B--?--Xo---?---M-Xo--o-----o-o---oEoB-?--------??-X-o-oX?o-B--B---X---?X?----?XoBX---o--BoB--E--B-M?Bo--o--EoB-B?
-?--BB--M-?-M-M--M------B-MXooMB--?----M----?o--------Bo---M-MM-----?X---o?XMMoX?-------o--?-?X-----B--BM??MX?MBooooBBM-M??----oEBX--M----Mo-B---o-E?-X-o-X-?-B-ooBM-XB-o-M-Boo----BB-o-B---XMMMXBB----M
M--M--------BB--------X-----X---o?MMM-B-BoX--BME-BMBX--X-MB-o--EB--?-Bo-oo-MXBXX-X-XoBo-XBB-T-o-MBoB-|-----B-?--M?-B-M-XX-----?XX-oo--?o-o----oo?XBX----ooX----XM?--X---M--M-XoBo-M-?oM---MME---oXoMM-XE
|E--BX-B-ooo?X-?-E?----o--oB-o-----o-----?oX--MMB---?Xo----?o?BM-??-?----o-B--?o-oBB--XE----|??---o-oXo---?---------B-?oB-oM----B-B----X--BBXB-B------Bo----------X?X-Bo----?o--X------o----??-??o?--oB|
mX-X--?-o??--oo-oM--o-oBB---o--ooX-?o-X?B-BoXXoo--|X--o-??o-B---B----X--B?---|-ooB--oo-M?X-BX---??X---B-B?-XX?Xoo?X?-----o??-?-X-o--B|-Bo-----o--XXo-o-oXB-BB||XBoo--?-o-oB?-o-o?-?-Xo-Bo-X-|-o----X-?-o
XXXXXX--X--X-XXXXXXXXXX--XX-XXXXXXX-XXX--X-XXXXXXXXXXXXX--XX-XXX-XXXXXXX--XX-XXXX-XXXXXX-XX-X-XX--XXXX-X--XX-XXXX-X-XX-XXX--X-XX-XXX-XX-XXXXXXXXXXXXXXXXX-X--XXX-XX-X-XXXX---XXX-X-XXXX-XXXXX-XXXXXX--XX
