o-------------------------------------------------------------------------------------------------------------------------------------------------------------------------------------------------------
?------------------------------------------------------------------------------------------------------------------------------------------------------------------------------------------------------|
|------------------------------------------------------------------------------------------------------------------------------------------------------------------------------------------------------T
?------------------------------------------------------------------------------------------------------------------------------------------------------------------------------------------------------|
X------------------------------------------------------------------------------------------------------------------------------------------------------------------------------------------------------o
E-o?-?B--Bo?-X--X?--E-?BBoB-M--M-------?-B?--?o--BoMo?B-o?B-o-BB?MEBMX--ooM-Bo?----M-M--MB-X?oBMMoMoM-B--?o-XMooo-?--oB-MM-X-?BMM?Mo?--Xo-MX-MBB-X-M?oX?M-BB?E?-X--o-oMX-oo--oBBoo-MXB-oM---oBo------BB?
??------o------o-o--B-o------o?--oBo?--oo--o----Xo?o?-oX---?o-o-XBMo-Bo-Xo-----MBB--?--o--oXo?---M-XoooBooB??-o-M-o-----o-E-o-o----B-X?BB--o-o--B-o--MM-----MB-o--oX-MoMoB?-oM--Xo-oX---o-X?--BEMM-?---T
?--MXoo-MB---Moo-o-oXB?--XMM-Boo-X-?-Mo-M--?o--?oX-B--Bo-----o-o-MM---M?oB-o-o-o--?B-XBo---?--B---o--M--?-----M---Mo-EM-XMBBX?-?-oX---o--?-BBo-ooMo-oo--T--o?--EX-Xo--ooM---M--?X--o-X?oo-B--oM?ooX-BX?v
XM?-Mo-?----?oXo---XB--ooM-oM----BBo-oB--o-oo----X--?o-B-?--oo-Mo---?o--o-X?BMM-o--?X|-?-?BooM-B--Xo--o---Xo---o---M??-MMoXM------oo------?---ooo--MMBBB|MMM-o-BB-M?---?oX-o--M-?-MXoM-oX--oB??Mo-M----T
B----?Mo-o---oBMoooE-M--X---o---o---BX--?M-?X-X?-MoB-?-oo-oXMBB-BooM-----o?o----T---oX?-?o-oo-ooo??M-oMXX---E--XEo?---?-oM--B-X--MX-?ooBX?----?MXE?-----X-oXM--X-X----B-E?--oo----oM--o-o?-Bo-?-XBoo-o?-
?-BB---oM?BoBM---B?MX--E--------XMo--o-----?-oo-BoM--oo?--?o---B-----oo-o----o--|o?oMB-----EX---B-o-?M--o-B-??-??Boo---?ooM---BMX-M?-BX-o-XoBo-o-?---M-oooB|o-oX---M----?--?-oXoXMX-B?MMo-BoX---B--o-M-|
|B-----M--oo-ooXoB-BB?-BoX-X-?oEo-XMoo-o?BooBEM---oBB?--o?o-------BBoM---XB?oBE-XX-M-o-X--oM-M-B-------?X---X---o--B|-o-Xo--oo-o----?-o--X?o-Bo-E-X---X-XE-XXB--X-?-?BoE-?-ooB??--?E----B---B-o---M?--oM
---X--Mo-B-M--?o--M---BBo-?-XX?XM-?o-B-X-o---X--B??--o--?---?--o-Bo-Mo-oX---?-Mo-MM-X--?-??o-----o-XB-----oXEo??---oX-?-XM--X?B?B?-oo-X----X---BX-B-oX-Eo??M--B----o-oX?o-E?oo-----B--oB-E---oMo-o--MX??
---Eo-oo--X-o---E----o-----o--M?--XMoo------Bo-ooo--X---------E----o-o---X--o-oo----o---Xo-XXooo---------X?B?X---X-----X--Eo--------o---o----E---E--BXXMM-o-XX-o-oXXo----XMoX-----EX----MX-X----X?XMoo-E
m--MX---o---oo-X?oX-oo-|oXoX-Xo-Xo---oo----o---o-o-ooo-o--ooBMM?-oXoX-----oXX-o---oX---o--ooXXooo-X--o-X-X|XX----oXoo--Xoo??BXB--o--oo-o--X-?M--?XoXoX---o-Xo-X-oo-o-oooooX|---o-?Bo-|-o--o--o?--o----||
XXXXXXXXXXXXXXXXXXXXXXXXXXXXXXXXXXXXXXXXXXXXXXXXXXXXXXXXXXXXXXXXXXXXXXXXXXXXXXXXXXXXXXXXXXXXXXXXXXXXXXXXXXXXXXXXXXXXXXXXXXXXXXXXXXXXXXXXXXXXXXXXXXXXXXXXXXXXXXXXXXXXXXXXXXXXXXXXXXXXXXXXXXXXXXXXXXXXXXXX
