?------------------------------------------------------------------------------------------------------------------------------------------------------------------------------------------------------T
X------------------------------------------------------------------------------------------------------------------------------------------------------------------------------------------------------E
X-------------------------------------------------------------------------------------------------------------------------------------------------------------------------------------------------------
X------------------------------------------------------------------------------------------------------------------------------------------------------------------------------------------------------B
o------------------------------------------------------------------------------------------------------------------------------------------------------------------------------------------------------E
T|-oMBo??-MB-XXB-?ME---oo-M----o?MBo-o--MM?oo--oXX-oB-oXo?oE-BXMo--oEX-X-BXEo-?-Boo-X?M?XX-----?B?--X-oBBEMXMooo?B-BMX-o---oXo---o-Bo-EMMooMX?o?-MB--ooXM?oEM?-Mo-oX-XXXM?-BBME-XM?M-B-??oXX-oBM-MB-X--M
oX-o--B--M--X-?-B-M?o?oM-M-X-o?-----o-X?---X-?XMo??M-oB---X?o-M-MoBX?oE--BM??----?ToM----o-MoM----oX?Mo--M---BMo--B---XX|o-o-?BoMX--o-B--Mo-M------?-BM---XM----BX--?-oo-----MB-o---o-o---B-oE--o-----BB
--Mo-E-----X?B---o-MB-B-?--X-E-M-X-oM----|-oX-B-?---oB-o-o-Bo-------?XBBE-X---o?--|M-?XB-?-----|--BM-X?MM-?-?--B------MMXB-M-----BX?BBo------B---X------MBX--BM--o-M-?--o-o--XB-----X-BBME-X??BoMoX?T--v
MB-BXX???M----o-BMM----B-MMB?B--M--B---XXXXB-B----X?o-BB?B--XoX-X------M?--X-BE-MMX-X-o-M--XMMMX-?--o---XB-?--B-X-EXo---?-o-Bo-o--o----?--XM-----oo-?X-M---XX---??E-B-o-B-o----M??XBM?--MBXXoX-B-oo-|--?
----oMB---|--oX-----Bo------oooX-----oo-M-M-M-o-o-M-MX----M-----oMooXB-?MM--BMMB---oo-----o--------B--o-M-M------MMXBB-o--Mo-B-X--oX------E-?oB?M-?o--o---ooM---X?B?--M---B-XEo---E---MX--M--oB-M?-oX--o
-M-B------X--MBo-M-X-MEB--B--MXB----?-BB-o----MMX--?-o-----oM?--X-?Mo-o----o--?B--M--XoX--XM----o---o?XB-B-B-B--oXBB--X?---T----M--B--oo-oM--M---E-E--B-oMXM-o-B--X--?-o-o-?XX??MB?-BX-B-o-E-M----oM-B-T
X---B-M-?B-----XE--BBX?--X-B?-X--Xoo-o---?-M-B-?-BX--B---EB---oXXM--EMo----MM----M-?--MT?-X-oB-o?-?-?-X-E---X-o-M---X---M-MXB?o---o--X?-ME-BX--?BXXXXo----?-M----B-?--o-XM-?M?---BXX--?--?BXM----M--o-B-
?-?----B---E-o-XXMB---o-E?B--B-?-----o-B--B-o-E-----o-???M-T?----?B?B-XoooX----M--o----X---??------B--XMMoo--o-M--?B--X--B-E--oB-??M---X?BM-M|-X--|-oB-oX--B-B-?--o-M-?-X-?---?---?TMo---MBB-X-o--M-Eo-o
|--??-o--B-B-?X-o--B-?-??--o--o---oo--B-Bo--MBB-oXoo-------|-BoBB--oo-?-XX-B------X----B-E------o---?BX-?o-B----oo--XE--X-??--B---------BB-X-X--o-XB-MBBoBB-B-?-oBBB----o----X-B---|---o---B?-o-BoX??Xoo
m-M--oo-?-oX?-B?ooB-X---Bo-B?X--X-Xo-o---o?B?o?-XBoX---B-|BXX-o---XB-o--oB---?o?-B??-o---Xo-------?X--Bo--o-----?---oX-o-B-??o-B-o--?----o-ooXo-B?-----------B-X---o--X?o??X-XB-oX-XX?B-B?o-o----B-B-o?M
XXXX-XXX-XXX-X--XX-XX-X--XX--XXXXXXXXXXX-X---X-XX-XXXXX-XX-XXXXXX-X-XXXXX-XXX-X-X---XXXXXXXXXXXXXX-X---XXXXXXXXX-XX-XXXXX-X--XX-XXXX-XXXXXXXXXXX--XXXXXXXXXXX-XXX-XXXXX-X--XX-XXXXXXX--X--XXXXXXX-X-XX-X
