--------------------------------------------------------------------------------------------------------------------------------------------------------------------------------------------------------
--------------------------------------------------------------------------------------------------------------------------------------------------------------------------------------------------------
--------------------------------------------------------------------------------------------------------------------------------------------------------------------------------------------------------
--------------------------------------------------------------------------------------------------------------------------------------------------------------------------------------------------------
--------------------------------------------------------------------------------------------------------------------------------------------------------------------------------------------------------
--XMBMBT--B?XMBXX-??M----?MX-M?---MB-MM---X--X---MT?M---M?-BX------TM--------?X?-----MMMo---B------oXo--?----X----?M?B-Xo-BM-XXM-B--?BX-MM-M?--M-----M-?---MB-XB-o-X-B-MM--?X---B--MBBBo-B---M----X-----
-------|-X----oX-?o----??--?----B---B--?-M--M--X--X--MXM--Mo-MM-o?-|--?----?-----oX--o--X-?---XB?-?B?B---B--X-MXX-o---B?B--oXX--?-X---B-o-X--?--TBM-BoE-?-X------?XMMoM--B?-B?---------BB-MXM-o?M--B----
-BMB?M-X?MMXo--BM-?---?---M--XM-o-?-o?--oo---BM--X---oM-X--MB--?--?X-----M?-?-------XM--M--BM----X-------oo------B-?-----E-X-X-M-------X-?X----o|---MMM?--EM-?----X--?o----Xo--B------?----o-BX-o-o-?XMv
--o---B-----XX--o--B--o-------oXXM----BMX-----------M---BXo-o-?--?-M-X-M-ooX-------M-o-?--X-----o--X--X---B--BXEM----o--??XBM?--?-M-----?--X---?X--E-??--BM-M--o-XXMB---B--X?B-o?XMX?---?--BB-o--MX----f
--o-MX---o-B--------X-M---?-----?o-?-----oB-----??B----X--?BB----oo--?-oB--B-BM-oM-o--M--?o?B---?-??M--M----M--?-X--?----B------oB--?--X--BX-----oX?X-X-B--Xo-?BM-Bo-BX--?-M--?X-----M------oM-XX----?-f
---B----X-o-BB-Bo-?-T-oX?MoX--?X--?--------X---------o----o--?----?---XM--?---oMB-XB--oX----o?X---o-o-M-M--Bo-XX--X--?-----------o---X?-BX-Bo?-X-?---B-------o---B--o--X--X--X-X-------MB-----o-M------f
-----oXMB----oB-BB--|X---oBBBB--X--?X------MX-B--o--?M-oXM-----XB?-?--?o-?---------oB---?M-?Bo-?-?X-------?oX------??oB?M----Bo--X?MX--o--?-----B--------B--??--o---?--X-MB--------B?--o-X----?X-o-----f
-?-X?X----?-MM-Bo---X?---?-----X?-oooM-------E-M---?-------X?X-M-o---B----oX?-X-B--------oB---X------X-BM--X?o?--M?---o---?MXo-BEX----X?oM----XX---B--??Mo-o--?o?--X--B---oX----M?---M-?-------XEXX-X-Bf
------E----X-o--XX--X----o------o-X--oX--X-------X--X---o---------T---X-o---o---------X--o--X--------------oo-------------o---XX?B--------X--X----T-----oX----o--------------X-----T-o--oo--XX--M-X----f
m--oMXMM-------X-X----------------------X--------o-----o?--X-X----|--------------X-X--X------X-o-----------B---o-------o-------------X--------X---|------X--------X----------------|---------X---------X
XXX-XXX--XX--XX-XXXXXXX-XXXXXXXX-XX-XXXXXXXX--X-XXX-X-X-XXXX--X--XX-XXXX--XX-XX-XXXX--X-X-XXX--X--X-XXXXXXXXX-XX--XXXXXXX-XXX-XXXX-XXXX-XX--XXXXX-X--XX--X-X-XX-XXXXX--XX--XXXXX-XXX--XX--XX-XXXXXXXXXXX
