T-------------------------------------------------------------------------------------------------------------------------------------------------------------------------------------------------------
X------------------------------------------------------------------------------------------------------------------------------------------------------------------------------------------------------?
M------------------------------------------------------------------------------------------------------------------------------------------------------------------------------------------------------?
X------------------------------------------------------------------------------------------------------------------------------------------------------------------------------------------------------|
|------------------------------------------------------------------------------------------------------------------------------------------------------------------------------------------------------B
XBo-?-?--M-BBEoM?M-BMXB-B---?Mo----?o?MB?--oBMX-oXo-MoB?o?XB-B--E---M-X?-o-B?B-?T-XBB-BME-oX-M-XXoM?-?o-XMoBB-o?M-XB-ooM-?-MBoB?Bo-XB---o-?o?E|M-M-BoMoBo?BXoo-X-M--BXo-Xo?B???-X----?o-?-B?B-M?Moo-MM-T
---o-?--B--XXBX---?--E-B--M?--?X--B-M----o-X--o----M-o--M-M-o-B??B-o-----M------|o---B--M-XBo-oM?o--T--------M---oo-o-?---o--X---X?o--o?---MMBX-----?-o-?--oM??-M----XBE-X-----BBB--M-?B---------?-M--?T
M-oB---X--Xo--M-Xo-MX?M-----Eo-oo--X-o-??X--B-B?o?o--M---o-oB-----MBoMMB----BB--XMXM?-oMBE--?BB-----|?o?o-o-?-XoM-X-?---o-BB--o------Bo-o-----XB--o--B-----o---o--MB---MXXo--o----M?----X?M--oo---M-M--v
M------M--oMM?MXBM-o?BX-BoBMBXo-M---XB-BoX------------BB-?B----M-o--o---BBoX--?-o-X--??--?-o-----o--X-o-E-BB--BX-oMo-?-Boo--oX?-XB-oo-M-M-X-oMo-M-oBX-?B-BXM?--Xo----o--Mo-X-?---X--Bo-----?-MoX-?-MXBMX
M-X-oo----B---Mo---?-----oo-M-BX---?--M-MM---Bo-B?--?---B---o-o-?M--o--X--X--B----X------Mo?-??B--B----oX---Bo-o-?-X-----oXBMo-Bo------o-?--------o-oM----B----o---M-XBM-?-o---MMo---M---Xo-o-oX-----oE|
B??o?--E?M-EB??B-----o-o-??--o-MM-o-M--B---o--Bo--?--B-X-?--B-M---o-X?-M---M---X--B-oB-B--o-X---XX----X-X-X--XoBo-XMMMBoEB?--B-----??-BXB--B--M?X--oM---Mo----MM----B-----oXBM----EBo----MB--E-M--oXBB?M
M--M-?MB--?Bo-Mo?ooBMMXX-----M---BE-------?-M--MB---T--BX----o-Bo-B-B-o-M-M-o--?Mo----B----X?B--E----B-XX?--o-E--?o---X?B--o--?X-oo----o--E-----X?B---XM-M---M----?---??o-M-----???-?-MB?--oBBo--X?B?-oX
Xo----?B?--M-M-M-oM---B?BXBo--o?MMXXB-?o------E--?BX|MX--Bo-BB--MB-B--M--?--Xoo--E-oo-----oB---M?-------B-BB-?BXX-B--XX-X--X-M-BMBXM-?-??MXX-o--o--M--o---oBB-MX-----o--X--B-----?M--M----M--BXXXX---o?T
TB--------X-X---X--o-------BB-?--o---B-o--ooX-M-o--?X-X-B--X---B--o-?--oB--X-Xo?M?XBBX--E-B--EX-oXo-Xo-?--------?--?-X?Xo-o?o-------?-----|?-?X?X----o--X-X----------?-Bo----XoEo--?--B-X--oB-XXEX---T-M
m-oBo-o?XBXX-o?Xo?-ooX-|B-o--o---BoBo--X-XXB-o--BoB-Xoo----B-oo-oo---o-?------?--XB--oMB??-XBX-oo?-oXo---|o?|?o--X?-BB--X-B-Bo-o--o--?o?oBX-o-B-?B---X---o----o-o-X-B-o-B-B?o?BMB??-BB-oo-Mo-XTBXooooXBM
X-X-XXX-XXXXXX-XX-XXXXXX-XXXXXXXX-X-XXXXXXX-XXXX-X--XXXXX-X-XXXXXXXXXXX--XXXXX-XXX-X-XXXXXXXXXXXX-XXXXX-XXX-X-XXXX-X---XXX-X-XXXXXX-X-X-X-XXXX----X-XXXXXXXX-XXXXXXX--XX-X--X-XXX--X--XXXXXXXXXXXXXXXXXX
