--------------------------------------------------------------------------------------------------------------------------------------------------------------------------------------------------------
--------------------------------------------------------------------------------------------------------------------------------------------------------------------------------------------------------
--------------------------------------------------------------------------------------------------------------------------------------------------------------------------------------------------------
--------------------------------------------------------------------------------------------------------------------------------------------------------------------------------------------------------
--------------------------------------------------------------------------------------------------------------------------------------------------------------------------------------------------------
-XXM-?-BM-B?EM---BX?---XX----B-??-B-----?o-?----Mo-M-oM-?--MX?--?MM-?M??-M--?-M-B--M?---?E?-XX---------MM-o----X------oB--o-MB--MBX-?-M?---?XM--XX---BX-?oBB-oM--M?--XEXMX--M--X-?X--TMo??-B-oB?B?M?----
----?-----MMB--?----??-?-?BM?-M---oM-M?M-B-------M---?-B-BX---o?--------?------o-------M-M---B-oXB--?XBo-?B?-BXX----M-B--M?M--o--o-----oX-M---B-?--o--M-oB--BX-X---X?XB?-X---M--o-M--|-?--o--X--------?-
-M----MX-X----X---MXo--oo----?--o-B---o-----M--XB----oM---MX-oX---X-X---------TB----B-Mo-------BB-?-o-o?-----o?--MX----MB-----?Mo-MB?M-M-------B-XBXXM-X--M-o?oXX---X-?X-M----?BXM---XX-X-M--M-B-B--?--v
-------B---X-?-M--o-M--oX--M--?XB---?-E?-----XM--XMM-B---------oX-M--XX?----B-|o-M---?-B--BM?B-----X?-XoM?--Bo--M-X--------M----?o----?-o---XBo----?-----o-M-----M-B--o-?oM-----M--X----o-----?oooB----f
--X-oMo-?-X-?----M-E---MM------o-o-X--X-X-?M---?-------M---M-M-B-M-B-?---M-X--Xo--M------M-o--BBX--M--?M-o---X-X--?--?B?------o--B-X---BBX-X--MX-BX--ooM-M--X?-X--?oE-------B-?---B---??M--?---B?--X-X-f
--o-----oT-o--?---XM-----?B--MXMMM-Mo---X---BX--BX--B--o--------?-B---?-?-BB-X-X-M--??--?--MX---X-B-o--o--B--?--B--?---oo---MM?B-o-MX--oo?--B-o--oB---X-T---oo---B--BB-M-----?---M-MX-o------BXo---X--?f
-?-----?M|---B--?-M-X-------B-X---?-MB?M?--o--X--?-B-XB---M-?XM---o-X-o------M-??-XX--------B---o---X-Mo------X--------XB?--o---oM-o--BM----o-?M---XXM--|--Bo--?--------M?-M-oX-?oo-M--X-B--?o?X-B-XBM-f
----o----XB?B-X--?-X-Bo------E?---------oBX?-?M------?--XMo----B-?-?--------Bo---B-?-----o------MM-M-XoX-ME-M??XB--?-XBB----MM-BM--X--o----o-----------BX?--B----o?---B-o-Xo--?-oXX----?------o-B--M---f
----------o----X------X-X-E--X---o----o--o-oXo-X-----oo-------o-------X----X------X-X--X---------o------MB??-----------------------T-------X---X-X----------------------------o---------X--------o-----f
m------o------X--------XX-M-o-------o-XX---o----X--M-------oo-------------------X----------X-----Bo----X--X---------o---oX-----BXX-|-----XXo-----XX------o-------X-X---o--------X---X------o---oX------X
X-XXXX-XXX-XX-XX-XX-X-X-X-XXXXX--XXXX--XXX--X--XX--XXXXX-XXXXXX-XXX-XXX--X-X-XX-X--XXXXXXXXXXXXXX-XXXXXX--X-X-XXXXXXXX-XXXXXX-X--XXXXXX--XXXX-XXX-XXXXX-XXXXXXX--XX-XXXXX-XX-X-XXXXX-X-XXX-XXXXXX-X--X-X
