----------------------M-------------------------------------------------------------------o----------------o---------------------o-o--------------------------------------------------------------------
------------o-------------------------o---------------------o----------o--------------------------------------------------------------------------------------------X--------------X--------------------
------------------------------------------------------o----------------------------------------------X-M-----------------X----------------------------------------M-o-----------------------------------
-----------------------------o--------------------------Xo------------M-------M-------------------------------------------------------------------------o-----------------------X-----------------------
---------------------------o-o------o-------------------------------------X---------------o-----------X------------------------------------------------------------------M-----------o------------------
---MX-o---M-?o-?M?M-M??X--?o?BMM-BM--XX-?---??-X--X??--?X-----XM--?o-M----?----?B?--X--BBX-??M---XB?--X-BBXo?B-XM?X-MX---BX-o-?--XM--------X-B-o-X?---?MMX-Bo-XM-X?---o-X-----BB--MEMXB-?XXB---MX----MM-
------XX-------o--o------B-B---o?oo--?X---B---?o--M--MB-----X---?--------B---?----?-----o----o-XB-oo-B-B---B--B----MBX--B-B-o---oo-------X---oX?B--?--o-oMX-?--oX--X--o--M-BMX---?XXo-o?--?-?-----B?----
--?--------M-?-XM----X-M--o-?----??-----X--------Bo--ooX-X---Xo----?--oBoo---o-MM--?----BXo------MM-M-Xo-?-o??-XMBo---------BMM-XXXX-B---?--?-M---o-E?BM--M--XBo-o-B----Mo-oo---X?XM-o---Xo--o-M-B--?-ov
-M--?o-X----X-oXo--?--o--B?-oXXBo--M-------X?-B-B-?----EXX-BX?---X--X----?--BX----B-MoXo-----M------BXX??-X?-o-o--?EMX----M--o---o?B------M--o---?Xo-o---X--M--M-B---B-?o-?XB--oB--o?---B-o?-?--?--oo-Mf
---oo-o-o-B?-XMX?-?o--BB-X--?X--?-o--ooo--?--?--o--X--XMBXE---?o------B---BM-X-MX---?-??-?--X-o?-XME-M---?-o-M-B---X-M-M-----?-----o--X---------------B?MB--oM--M--?--?--M---M----o--?X-oBBo---B---MMX-f
---M?o-?B-o-MMo----oB-------oXMM-M?----o-?-?Mo-M??o------XBXX-----?BXX-BXM---?o---X---o-X-???-----oX-o-o-o--------o-X------o--B------BMB---?--M---X-o---o-------o?--X---?o-?-------B-oB--ooMBo---oo--?of
-?--oB---BX-oo-MX-o-o--?B-BX--o-Mo-M---X?o---B----M----M-XX-X---X------o----?o---M---o-B-----?MX--XoXXXMMM--X?XMX--X-----?XX---E------o--M----o-B---XB?-XB?--BM-M-X-X-X--X-------------o--o--X-o-?oo---f
--X-X-B-B-B?MB---ME--M--o----B--o------B-MB-----XM---M-ooM-BXBE----BX-X-X-?Xo--------MM-----?--MXX-oBXEo-o-M---o---B-oXXB-----E---X---BX--XoX-oM-XX---o?--o-X----?MB------?-B--MM?B--M--o-----XM------Bf
----------oo---o--B------------------Xo--oo-----------o-ooo--MMo-o-oo-X----------X-------X--o-X--X-X-MM--o------------oooX--X--------o----------o-X-XX--o----------------------o-o---oX--X---------T-o-f
mo------------o-------X-------------X-----o--X---------------X-X--X---o--o--------------X----X---M---------X---X--o-XX-----XX--X-o---X----o-----X-X-M--XM---o----------o-X---------M-----------o-X-|o--X
XXX-XXXXXX-X--XX-XXX--X-XXXX-XXX-XXXXX--XXXXXXXXXXXX-MoXXXX--XXX-XXXXXX--XXXXX-X--X-XX-X-X--X-XXX---X-X--XXXXXXX-XXXX-XXXXXXXXX-XXX-XXXXX--XXXXXXX-X-XXXX-XXXX-X-XXXXX--X-XXX-XXXXXXXX-X-XX--X-XX-XX-X-X
