|------------------------------------------------------------------------------------------------------------------------------------------------------------------------------------------------------o
X------------------------------------------------------------------------------------------------------------------------------------------------------------------------------------------------------X
?------------------------------------------------------------------------------------------------------------------------------------------------------------------------------------------------------B
E------------------------------------------------------------------------------------------------------------------------------------------------------------------------------------------------------M
B------------------------------------------------------------------------------------------------------------------------------------------------------------------------------------------------------T
X-B-B--B-Mo-o?-MMBM-oM-oX-BoXoooo-EBoBE?-E-B-?--M?--M?B?-----oo?B-BoM?B-ooX-??M?ooo-Bo--?-oM-?-?BB--?MooXoBM-oo?o-XXX-o-o?--ooMM??ooE?oX--XMXBo-o--?B-E-Boo-XoooB-X--Mo?B?-?-|-MoX-M-BM?MoB?-???BE--oB-E
TB-o-?M---??M-------o--X-o--XM-X--B-MXM-oBX-X-?---------o-?XooX----M-----oXB------Bo---?--X---M---Xo---oBB--ooX-M?-Mo--MB-MoXB----X?B-o---X-B-?--??--??o-Xo-XoM----M--B---M-MXB-BM--o----o--o----XT|?-o-
---X----oM--------X?M?oB-MBMM---XBX--XMM?o--oX-B--ooXXo-X|--??---o--oB??-o--B-?----E-oo--E-BM-----o?M?B---o-------X-o-o--M-MM-BBB---???-X-?o---?X----BEMo--oB---B------MXo---?----M-X--XM?---o-o--XX-o-v
|--oB-----MMX-X-XXX---o-------B?E-oM---o-X?BBoB-oXMMM-B-BX-X--MB??-EB---?M-M-?--?-X?EXo-XXE---o-oo-------?M--ooMB--o----B-X-------------?--?o?--?-o-X-?-?o-B-oo---B--M---?o----M-X-XB----------X-?XX?M-|
E?oB--o-MB--M-?o?----M----XBBX--B-----oo-?---B-ooB-----o--ooX--M-M?X--X---o-B-----X?BMXM-MMBX-X-MX-o-M-MX---o?X----oEMBB--E-Bo--?o-?M--o-|o-?-XX---BBE?--TB-B---MX-oo--oo-X?--M-EX-B-?-X---ooo?-X--o---M
|-M----M-----B-M--?-?-XoX-----XoBo-B?-B-B-??--M-M-XM-MoE--XXM-o-B--XooMBM--X---M-MXMo--B--?--Xo---?---M-Xo--o-----oEB----X?B-?--------o?-X-o-oX?o-B-XX---X---?X?----?XoBX-o-o-BBXB--E--B-M?Bo--o--EoB-B?
-?--BB--M-?-M-M--M----o-B-MXooMB--?----M----?o--------?M---M-MM-----?X---o?XX?X-?-------o--?-?X?----B--BM???XBBBoM?BBMMoX-?----o-BX--M----Mo-B---X?XBoX---X-?-B-o-BM-XB-o?BXBBM----MM-o-B---XMMMX-X----M
M--M---------o--------X-----X---oMMXMoB-BoXo-BME-BMBX--XEMB-o--EB--?-Bo-o--XB-oX-X-XoBo-XBB-T-o-MBoB-|-----B-?--M?-B-M-XX-----?X--oo--?o-o-----o?XM-----ooX----XM?--o---M--M-XoBo-M-?oM---MM----oXoMMBBE
|---BX-B-oo-?X-?-M?----o--oB-o-o---o-E---?oX--??B---?XBM?--??MX?-??-?----o-B--?--oBB--X-----|??---o-oXo---?---------B-?oBXMMM--oB-B----X--BBXB-B-o----Boo---------E?X-Bo-E--?o--X------MB---T?E??o?---B|
m--X--?-o??--oo-oo--o-oBB---o--ooX-MX?B?B-BoXXoo--|X--o-??o-B---B----Xo-B?---o-X?B--oo-o?X-BX---??X---B-B?--?-oTo?X?-----o??-?-X-o--B|-Bo-----o--XX--o-oXB-BB||XBo?--?-oMBB?-o-o?-?-Xo-Bo-X-|XM----X-?-o
XXXXXX--X--X-XXXXXXXXXX--XX-XXXXXXX-XXX--X-XXXXXXXXXXXXX--XX-XXX-XXXXXXX--XX-XXXX-XXXXXX-XX-X-XX--XXXX-X--XX-XXXX-X-XX-XXX--X-XX-XXX-XX-XXXXXXXXXXXXXXXXX-X--XXX-XX-X-XXXX---XXX-X-XXXX-XXXXX-XXXXXX--XX
