--------------------------------------------------------------------------------------------------------------------------------------------------------------------------------------------------------
-----------?------------------------------------------------------------------o------------------------------------------------------------------X------------------------------------------------------
-----------------------------X---------------------------------------------------------------------------------------------------------------------------------------------------------??????-----------
--------------------------------------------------------------------------------------------------------------------------------------------------------------------------------------------------------
--------------------------------------------------------------------------------------------------------------------------------------------------------------------------------------------------------
----------X--?-----o-----------------------------------------------------------------------------------------------------------------------------------------------------------------------------o------
------------------BB--------------------------------------------------------------------------------------------------------------------------------------------------------------o---------X-----------
----------------------o------------------------------------------------------------------X-------------------------------------X-----------------------------------------------------------XX----------v
------------------------------------------------------------------------------------------------------------------------------XX----------------------------------------------------------XXX----------f
-----------------------------------------------------------------------------------------------------------------------------XXX---------------------------------------------------------XXXX----------f
------T---------------------------------------------------------------------------------------------------------------------XXXX--------------------------------------------------------XXXXX----------f
------|--------------------------------------------------------------------------------------------------------------------XXXXX-------------------------------------------------------XXXXXX----------f
------|-------------------------------------------------------------------------------------------------------------------XXXXXX------------T---------------BBBBB---------------------XXXXXXX----------f
------|-------T----------------------------------------------------------------------------------------------------------XXXXXXX------------|----------------------------------------XXXXXXXX----------f
m-----|-------|BBBBBB---------------------------------------------------------------------------------------------------XXXXXXXX------------|---------------------------------------XXXXXXXXX----------X
XXXXXX|XBBBBBB|XXXXXXXXXXXXXXXXXXXXXXXXXXXXXXXXXXXXXXXXXXXXXXXXXXXXXXXXXXXXXXXXXXXXXXXXXXXXXXXXXXXXXXXXXXXXXXXXXXXXX---XXXXXXXXXXXXX-------X|XXXXXXXXXXXXXXXXXXXX------XXXXXXXXXXXXXXXXXXXXXXXXXXXXXXXXX
