----------------------------------------------------------------------------------M---------------------------------------------------------------------------------------------------------------------
---X-------------------------------------------------------------------------------------------------M--------------------------------------------------------------------------------------------------
--------------------------------------------------------------------------------------------------------------------------------------------------------------------------------------------------------
--------------------------------------------------------------------------------------------------------------------------------------------------------------------------------------------------------
--M-----------------------------------------o-----------------------------------------------------X-----------------------------------------------------------------------------------------------------
----?---M-B-X--------X--?M?B----XTB-o-BX--X--B---MB------X---?XB-?B-X-------X---?-M?-MB-B------B-X-?------B?-?-----B-?-?-BMM--B-?---M-?---?M-X-M--BX?-X---oBMMX-B?-?-BX-o-------X--?-X?-?--XM---?---X-X-
-----XBB-Xo?----MMBMXB---o--B---M|--XX-----X--B--------?BB-X-oX-?--?----M-B--BX--oo----B---BX-B-BX?-BB---Xo----XXBM-BoX--------X-?-X-?--X---??M--M----M--o?o----o--oX--?-X-M-B-B-B-o-MoM-BM--B-----B----
--------??---?--oo----?--B-B-B?--X---M-?-?B----XB----X---------------XXX-X---o-----X?-?------B------o--MB-MM--MBX----M-oBB--MX--B---o--BB------?---BXoo--X----?---MM-X--X?Mo?-M-?o--MoX-M---X-B-M?M-MX?v
-XB-o-B-o--------?B-----X-----o---BBXo-oMo--MX?--M-X?-MM--?X?B--B-?--?----BX----B---------?B---M--XoBMM-----X----MB--o?B-o-M------B---M--B------B?-oM-?B--X----XX--------ooXo-------o??Xo?--M----o--MB-f
----o----?--BMX-M---?-B--M-B----------------oB-----M-oo-MM--o-------Xo-BM--o-?--o--BB-M?------?o-B--oo-?X-M-M-M-----?-o-?-B-M?-M--oB------------------oo-o------??---X-oB----?--B---?--?--?M--M--B-X---f
-MX-------B-ooX-o--oo----o--?-----?--o--M----oB---------oo-----B--?o--Bo--MM--XM-?---B----B--M--B---o-o----?-B-XX----M-------oM-X---X----MBX-??-----X-B-B-BM-M-Xo--X-------XMo--------------XX----B--X-f
---X----??-----B---X?X--BX--oB----oo--X--X-M?----?-MMM-M---o----B-o?--o-----M-X-----o----M--B--X--Bo?M--?-----Mo?--?-o?M?-------B-----M?--o-B--o---XM----?----?M---------X?B--B-??-M-MoB-M----B-----B--f
---M--M--o-?----X--?oX-----X-oBX-X--B--M----o-------o--o?X-XM-?----o----------E?-M?-B--?------B---ooo-?--??---oB-----M------X?B-----M---?B-------?X-oB---------o---MX---MB-o-X--------?-oo-----X---Mo-Xf
---o--------T-----X-------X------------------B-X-o----XXo----o-E-------X-----?Mo----o---o---X--EX----o---o---------X---------o---X--o---------X-------X-------------oo------XXX-------oX---------------f
m-----------|X--X----X----------------X--------X------X----XX--B---o-X-X----XX---------------XMM--------------------X-----X-----------X------X----X-------X------o--------------X-X------X-------------X
XXXXX-X--XX-XXXX--XXXXX--XXXXXXXX-XX-XX--XXXXXX-X--XX--XXoXXXXXXXX--X-X--XXXXXXXXXXXXXX-XXX--X--XX--X-XXXX-X--X-XXXXXX-X-X--XXXXXX-XX-XX-XXXXX--X-X-XXX-XXXXXXX-X--X-XX-X-X-XXXX-X-XX-XXX--XX-XX-XX--X-X
