o-------------------------------------------------------------------------------------------------------------------------------------------------------------------------------------------------------
?------------------------------------------------------------------------------------------------------------------------------------------------------------------------------------------------------|
|------------------------------------------------------------------------------------------------------------------------------------------------------------------------------------------------------T
?------------------------------------------------------------------------------------------------------------------------------------------------------------------------------------------------------|
X------------------------------------------------------------------------------------------------------------------------------------------------------------------------------------------------------o
E-o?E?B--Bo?-X--X?----?BBoBEM--Mo------?-B?--?o--BoMo?Boo?B-o-BB?MEBMX--ooMEBo?----M-M--MB-X?oBMMoMoM-Bo-?o-XMo-oo?o-oB-MM-Xo?BMM?Mo?-oXo-MX-MBB-X-M?oX?M-BB?E?-X--o-oMXooo--oBBo-EMXB-oM---oBo-----oBB?
??-BX---o------o----o--o--BXoo?o-oBo?--oo--o----X-?-?-oX---?o--o-M?--Bo-XoMM-E-MBB--?o-o--oX-?---M-X-ooBo-B??-o-M-o--Eo-----o------BoX?BB--o---oB-o--MM-----oX-o--oX-M-MoB?-oM--Xo?-X-----X?EoB-MM-?-o-T
?--MXoo-MB---Mooo--oXB?-oXMM-B--EX-?oMo-M--?---?oX-B--Bo---o-o-o-MM--oM?oB-o-M----?B-TBo---?--B---o--MEo?-oo--M--EMo-MM--M--X?-?--Xo-----?-BB-Eo-Mo-o--oT--o?---X-Xo--ooM---M--?X--o-X?o--BB?o--ooX-BX?v
XM?-Mo-?----?-Xo---XB--ooM--M---XBBo--B--o-oo----X--?--B-?--oo-Mo---?-o-o-X?BMM-o-o-o|-?-?B-oM-B--Xo--?---Xoo--o-M-oMM-MM-XM---oo-oo----o-?--??o---MMBBB|MMMoo--B-M?---?-X-oo-Mo?-MXoMooX--oB?BM--M----T
B-oo-?M--o--ooBMoooE-MM-X-oo---oo---BX-E?M-?X-X?-MoBo?o-oooXMBB-B-oM------?o-o-oT---oX?-?-o-ooo-o??M-oMXX-o-Eo-X-o?---?--M--B-X--MX-?ooBX?----?MX-?--o--X-o----XoXo---B--?-??oo----M-o--o?-B-o?oXB-o-o?-
?-BB---oM?BoBM---oMB----E-------XMo--oXB---?-oo-BoM---o?--?oo--B-----o--o---XB-E|o?-MB------X---B---?Mo-o-BBX?-?-B-o---?o-M---BMX-M?-BX-o-XoBooo---o-M----B|o-oX---M---E---?-oXo-??-B?MMo-B-X---B--o-M-|
|Bo---oMo-----oXoB-BB?--MX-X-?-E--XM-o-o?Bo-B-M----BB?-oo?--------B-oM---XB?-BE?XX-M---Xo-ooEM-B-------?X-o-o--ooo-B|-ooX---oo-----o?-o--X?ooBo-EEX-o-XoX-oXXB--X-?-?B-M-?--oB??--?E-oo-B--EB-oE--M?--oM
o--Xo-M--B-M--?o--M---BB--?-X-??oo?--B-X----o--oB??--o--?-o-?----B--M--oX---MBMBoMM-X--?-?M?X--oo-oXB-o---oXEo??-o--X-?oXM--X?B?B?----X----X---MB?M-oXo---?M--B---o-o-XX--E?o-o--M??M--?-E-?-oMMoo--MX??
----oE----Xoo----E---oo----o-ooM-oo-o-E--oo-Bo-oo---X---o-----Eo-----o---X--o-?o--o-o---X--XX--oo--------XTXM-o--X----oX---o-o---o-o---oo--o-E--oM------o--oXX--ooXX----oXX-X---o-EX---o??oX-E---oX--o-E
m--oXXB-ooBBoo---X?--M-|oXoX-Xo-Xo----X--------ooo----------XXX--oXoXo-----XXo----oX---o--ooXXooooXo-o-X-X|XXo-o-oX-o--XoooX???--o---o-o--XoBM----oXoX---o-Xo-X-o-ooooo-ooX|-----XXo-|-?B-oo-B----o----|
XXXXXXXXXXXXXXXXXXXXXXXXXXXXXXXXXXXXXXXXXXXXXXXXXXXXXXXXXXXXXXXXXXXXXXXXXXXXXXXXXXXXXXXXXXXXXXXXXXXXXXXXXXXXXXXXXXXXXXXXXXXXXXXXXXXXXXXXXXXXXXXXXXXXXXXXXXXXXXXXXXXXXXXXXXXXXXXXXXXXXXXXXXXXXXXXXXXXXXXX
