---------------------------------------------------------------------M----------------------------------------------------------------------------------------------------------------------------------
------------------------------------------------------------------------------------------------M-----------------------------------------------------------o-------------------------------------------
---------------------------------------------------------------------------------------------------------------------------------------------------o----------------------------------------------------
--------------------------------------------------------o-----------------------------------------------------------------------------------------------------------------------------------------------
------------------------------------------------------------------------------------------------------------------------------------------------------------------o-------------------------------------
-B-B---B--o-E-------??M-Bo------X--oo---?X-oE-Xo-X----o?X-------M---XM-----oB---o--o----E-?--------MBE?B-o--?B--?o---BE---------BoMM?o-----BB?--B--?--E---Xo-M--------E-M---?-?-?-----------B---------?-
-o-o?o---XM--M-----o---o-?----Bo---B-o-----?---Xo---------?B---------o----------o-----oBBM----E----o-Mo--X-----oo---M-?o-X-B--o-------o-o------o-Bo-XXMB-BEM--------BBMB----o--M-----?--------o-BM------
---X-o-------o-oM----B---------M-?M--B----M--------------------o----BMo-o-X---oo-----o----?X--M------X--M--o---?-BB-------o----oEX---X-------E----o-o?--X-B---?--X-E------o--o--M-?-oo---M?-?-BX-------v
-------X-----o-M-B--M--M-E--?-Mo---B-o---?-----XM-----?-o-o----X-o-------o-X-?X?---B----?-----B-oo---------MBo-------------o---------oo--oo?MXB---M------o-------XBB?----B---o---o-?--?--oo-----o--o--Mf
--M------X----------o---??---o-----oo-M-X----X-----X--o-B-o--X-oX--X----?---Eo-oo-Mo-----o-----M---B--?------X------o----oo----------B-B--B--B----oM?-Mo----oB-----M-B-----------o----oo---o-----M-?-M-f
-------o-B-o----oE---B------oB--------------X-----?o-?M--------X--X-o---oX-B-o---ooB-o-----o--B----oo------------Eo----M--X---E--o-o--o-Mo---M--?----B--XX?MM---B-B----------------X-o-M--------M------f
-----M-----M-Mo---B-Bo------X------o------------B-o?--o--oM---XX----X-B----oM?-------?--E--B-X--?M--oo--E---BB--??--oX-----M--B---X---B--?------------X----M-X-?------?---o----------BE----o-?------X--f
-----------oM--X-B---X-oooE---o----M----------M-----Eo--?--MM-M--BM---o-?------BM-------M-?-B------E----?-M--o---?-----E--------?EM-o--?o-----oB??--E-E---------X-X----------??--X-oB-Mo-?BX----B----o-f
--------E--o-oBXB-------o-X----------------------X--o-------o-----o--------Eo----------X-------------Eo-------o--o-----B--------?B-------o-E----M--?X--M-----------------o--oo----E-----------o-o------f
m------MM----X---o--------------o----o-------------------Xo--X--o--------M?B?-------o--------oXX-Xo-oX---------------B-----o--------------MX-----------------o------o------------?M--------------------X
X-XX-X--X-XXXX-X--XXXX-XX-XX-XXXXXXX--XXXX-XXXXXX-XX--XX-XX--X-X-X-XXX--X--X--X-X-XX-X--XXXX-XXXXX-XX-XX-XXX-XXXXX-X-X--XXXXX--XXXX--XX--XXXXXXXXXXX-XXXXXX-X--X-XX--X-XX-XXXXX-X--X-XXXXX--XX-XXX--XXXX
