--------------------------------------------------------------------------------------------------------------------------------------------------------------------------------------------------------
--------------------------------------------------------------------------------------------------------------------------------------------------------------------------------------------------------
--------------------------------------------------------------------------------------------------------------------------------------------------------------------------------------------------------
--------------------------------------------------------------------------------------------------------------------------------------------------------------------------------------------------------
--------------------------------------------------------------------------------------------------------------------------------------------------------------------------------------------------------
-XXM-?-BM-B?-M---BX?-o-XX----B-??-B-----?-E?----M--M--M-?--MX?-o?MM-?M??-M--?-M-B--M?---?-?-XX-----?---MM-o----X-------B----MBo-MBX-?-M?---?XM--XX---BX-?oBB-oM--M?--X-XMX--M--X-?Xo-TM-??-Bo-B?B?M?----
----?----------?-o--??-?-?BM?-M-o--M-M?M-BM------o---?oB-BXo---?-----oo-?-------o--oo--M-M---B--XB-o?XB---??-BXX----M-B--M?M--M-------o-X-M-E-B-?-----M--B--BX-X---X-----X---M----M--|-?o---Bo---o----?-
-M----MXXX----X---MX---------?---oBo--o-----M--X------M-o-MXXB----X-X-M--o----TB----B-Mo--o-----B-?----?-o-o--?--MXXo--MB----?-M--MB?M-M--MM?MoB---XB--X--M---oXX-ooX-?X--Eo-o?BXM---XXoX-M-oM-B-XX-?-ov
------oB---X-?-M----M---X--M--?XB---?--?-----XM--XMM-B-------XB-X-M--Xo-M?--B-|-?M---?-B--BM?Booo--X?-X-M?--B---M-X--------M----?---o-?o----XB-----?o?---o-M-----M?B----XXMM----M--X----oX----?-o-B----f
-oX--M-o?-Xo?----M-o----M--o--o--o-X----Xo?M---?---oo--M---M-M-o-MoB-?-----X--Xoo-M----o-M----BBX--M--?M-----X-X--?--?B?---o--E--B-X-----X-X---X-BXoB--M-M-o?o-X-oo-Eo----BoB-----B---BXX--?---MB--X-X-f
--X--------Bo-?---XB-----?B--MBMXX?Mo-X--X--BX-oBX--Bo----------?-B---?-?-BB-XE?-Mo-??--?--M-E--XoBoo--o--Bo-?--BB-?--------BXBB---MX----?--B---o-B---X-X----X---BoXBB-M--o--?---M-MX--------BX-o--X--?f
-?-----?M----B--?---X-------B---oB--MB-?---oo-X--?-B-XB-o-M-?XM-----X---o----??-?-XXo--------?---B--o-Mo----o-X---M----X-?-------M----BM-o----XXM--XXM-----B---?o-------M?MM--Xo?o--M--X-B--?o?X-B-XBM-f
---EM----X--B-X--?---B-----o-E?-------MoXB-?-?M------?--oo-E---B-?-?----Eo--B-?-o--?o-o------M-----M-X-X-M--XMXXBo-?-XBB----MMoBMo-X---o---------------BX?--?---X-?o--B----oM-X?oXB----?--MX----B--M--Xf
---B-------o---X--------X--B-Bo--------o-o--XooX----------oB-------o--X-B--X------X-X--X-----------o------o-oo---X?-E----o---------T----E------X-Xo-------------o------o----o------E----X-------o------f
m-------------X-----o--X?-o----------oXX----o---Xo-----------------------o------X------o---X-----X-----X--X--------BB---oX-----?oX-|---BBoXo-----XX--------------X-X------------X?MMM--o-o------X---o--X
XXXX-XXX-XXXXXX--XXXXXXXX--XX-XXXX--XXXX-XX--X-XXXXXXXX--XXX-XXXXXXXXXX-XX--XX--XX--XXXX-X-XXX-X-X-X-X-XX-XXX--XXXX--X-X-X--XXX--XXX-XX-XXX--X-XX-XXXXXXXXXX-XX--X--XX-XXX-X-XX-XXXXXXX-X--X-X--XXX-XXXX
