?------------------------------------------------------------------------------------------------------------------------------------------------------------------------------------------------------T
X------------------------------------------------------------------------------------------------------------------------------------------------------------------------------------------------------E
X-------------------------------------------------------------------------------------------------------------------------------------------------------------------------------------------------------
X------------------------------------------------------------------------------------------------------------------------------------------------------------------------------------------------------B
o------------------------------------------------------------------------------------------------------------------------------------------------------------------------------------------------------E
T|-oMBo??-MB-XXB-?ME---oo-Mo-E-o?MBo-o--MM?oo--oXX-oBooXo?oEoBXMo-oo-X-X-BXEo-?-Boo-X?M?XX----E?B?--X-oBBEMXMooo?B-BMX-o---oXo---o-Bo-EMMooMX?o?-MB-oooXM?oEM?-M--oX-XXXM?-BBM--XM?M-B-??oXX-oBM-MB-XE-M
oX-o--B--M--X-?-BXBBM?oM-M-X-??-----o-X?---X-?XMo??M-oB-E-X?o-M-MoBB-oE---?BM----?ToM----oEMoB?---oX?Mo-BM---BMo--B---XX|ooo-?BoMX--BBB--M--M------?-BM---BM----BX--?-oo--------o-----o---B-o---o--oM?BB
--Mo--M?B--X?B---oBMB-B-?--X---M-X-oM---T|-oX-B-?---oB-BXo-Bo-------XBBoEoXo--o?--|M-?XB-?B----|--BM-MBBM-?-?--B------MMXBoM-----BX?XBX------B---X------MBMX-BM--o-M-?--o-o--XB-----X-BBME-oXoXoMoX?TE-v
MB-X--o??M----o-BMM----B-MMB----Mo-B-o-XXXXB-B----X?o-BB?B--XoX-X-----XB?M-X-B--MMX-X-o-M--XMMMX-?--o---XB-?--B-X--Xo---?---Bo-o--o----?--XM-----oo-?X-M--EXX---??E-B---B-o----M??XBM?-XBXBXoXoB-o--?M-?
----oMB---|--oX-----Bo-------?MX-----oo-M-M-M-T-o-M-MX----M--o--oMooXB---M----o----oo--------------B--o-M-M--------XBB-o--Mo-B-X--oX--------?oB?M-?o--o-M???M---MMB?--M---B-X-o---E---MX--M--oB-M?EoX--o
-M-B------X--MB--M-X-M-B--B--MXB-|--?-BB-o----X-X--?-o------M?-oX-?Mo-oE---o--?B--M--XoX--XM----o---o?XB-B-B-B--oX-B--X?--------M--B--oo-oT--M---E-E--B-oMXM-o-B--X--?-BMo-B--??M?B-BX-B---E-M----XM-B-T
X---B-M-?B-----XE--BB----X-B?-X--Xoo-o---?-M-B-?-BX--Bo---B---o-Xo---XMBB--MM----M-?--Mo?-X-oB-o?-?o?-X-----X-o-ME--X-o-M-MXB?o---o--X?-ME|BX---XBXM?o----?-M----Bo?--o-XM-------BXX--?--oXB?----M--o-B-
?-?----B-----oXMBXB---o--?B--X-?-----o-B--B-o-E-----o-?BM---?----?--E-X-ooX---oM----E--X---??------B-----oo--o-???MB--X--B-E--oB-??M---MBMX-M|-Xo---oB-oX--B-B-?--o-M-?-X-?---?---?TMo---MBB-X----M-Eo-o
|--??-o--B---?X-o--B-?-?---o--o---oo--B-Bo--X-X-oX-o---------BoBB--o?-?-XX-B------BMXB-B-E------o---?BX-?o-B----oo--X---X-MB--B---------B--X-Xo---|BX??BoBB-B-?-oBB----oo----X-B---|---o------o-BoM?XB-o
m----o--?-oX?-B?ooB-X---Bo-B?X--X-Xo-o---o?B?|?-XB-X-o|B-|BXX-o---XB-o--oBo-o?o?-B??-o-??BX-------?X--Bo--------?---oo-o-B-??--BT---BB??-o-ooXo-B?|----------B-X---o--X?o??X?XB--X-XX?B-B?o-o----B-B-o?M
XXXX-XXX-XXX-X--XX-XX-X--XX--XXXXXXXXXXX-X---X-XX-XXXXX-XX-XXXXXX-X-XXXXX-XXX-X-X---XXXXXXXXXXXXXX-X---XXXXXXXXX-XX-XXXXX-X--XX-XXXX-XXXXXXXXXXX--XXXXXXXXXXX-XXX-XXXXX-X--XX-XXXXXXX--X--XXXXXXX-X-XX-X
