o------------------------------------------------------------------------------------------------------------------------------------------------------------------------------------------------------B
?------------------------------------------------------------------------------------------------------------------------------------------------------------------------------------------------------o
o------------------------------------------------------------------------------------------------------------------------------------------------------------------------------------------------------T
X------------------------------------------------------------------------------------------------------------------------------------------------------------------------------------------------------B
o------------------------------------------------------------------------------------------------------------------------------------------------------------------------------------------------------o
---oo-o--oo-------oXE-----o------EX-E-o----EX--XX--E-----EXo-ooo-|---X--E--EE--oX-----X-o--oEX---o--E--E--X-----E-Eoo----------E--Eo----EoX----X-EE-o--X-X|--o|--oX--X-oEX----oX-o---E-E-o-XE----Xo-----
Xo--oE--X-E--E--------X---Xo-X-XE--E-E--o-XEEE----------oX---EX--XX--E-EXE-E-----X--------oo--Eo--EEo----EEX----EEX---E-----oo--------oEXX--oo-X--X---o--E|EE-XoX--EE-E---X--E-o--X---o--oXEo-E------XXE
B---o----E-oEo-o-E--------E-------o-----Eo---------Xo-----o----o-X---EX-E-----oE-o----o----XX-TXo---X-X-Eo--oEoXXo-o------XEo----Xo----o-E-------XXoE-EoEoX---XX-----X--X-Xoo-E-------oE-X----o-XX-o---v
E--EX---o-E----E---XX---o--Xo--T----o-Eo-oo---------XX-------------oE-E--Xoo-XXE-----X----EEo-|-X-X--------EXX--XXo-------o-EX--------o--E-o-o--oo-oo--E---X----X-E-----E--o--o-EEX--o-----o----Eo-E---o
?-----X--oo---o-o--E------X-o--|---XEo-X----X-o-X-E--oX---EEoX-E-Eo-X---o---X----X--Eo---E--EEX--EXX-E--o------o------EX-oo-Xo--E-E-o--EEEoooo-Xo------------E--T-o----EX---E--E--oo-----------o-E---X--
?-T----o---o----EE-------X---E-XXE-E-------o--E-oo---X--o--E--X-----------X--XEE--T--------o----E-Xo-X------o--Eo--o-----X--------oo-X-----E-oo---X-X--E--Eo---E|-X-XX-Eo-XE-X-----o-----E-oX--XEoE-E-EB
?-|E-X-XX---X-----------E-Eoo-----------o-T--o------o--X----E--X--EoXEX-oXooo-----|--o-XoX-EXX-oo----X------o---X---E--E----o-E-X--E------------o-X-E--o-X-X--o-Xo----E-E---oE-X-----E--X-o--E--o--o--E?
M-XX-ooE-o----------EX---Eo-----oXE-X--oXXX--E-o---o-X-E-X-ooEE--o---------X---X--X--E-X----oX--XoE-EX-o--X----oXX--oXoXoo---X--EE-----oEEoX--EX-EX-o---E---X----E-o------oE----X--E------EoE---o--o--E|
o--T------oET-----------XoE--EE--X-X--o-X--EXoXXoT--o-EE--X----E--o--o-oX---o-T-E-----T-o-oE--XoX--Xoo---o--EE-EoE-oXE--X-------------ET-E-o------E---E----E--EoT--XX-----XE--o-oX-Eo--X--X-X--o---E---o
m--|E-o-----|oXo---X------X--o--ETTo---EX--X-E---|Eooo-X-o-oo-E-o-ooo--o-X|---|X-E----|-oX--o---oX---E-oXXX------o--oo-EoX-EXEo-X--E-EE|E------o-------E-----XE-|E----oE--XX----o--oo-o---o---E-------oX
XXXXXXXXXXXXXXXXXXXXXXXXXXXXXXXXXXXXXXXXXXXXXXXXXXXXXXXXXXXXXXXXXXXXXXXXXXXXXXXXXXXXXXXXXXXXXXXXXXXXXXXXXXXXXXXXXXXXXXXXXXXXXXXXXXXXXXXXXXXXXXXXXXXXXXXXXXXXXXXXXXXXXXXXXXXXXXXXXXXXXXXXXXXXXXXXXXXXXXXX
