--------------------------------------------------------------------------------------------------------------------------------------------------------------------------------------------------------
--------------------------------------------------------------------------------------------------------------------------------------------------------------------------------------------------------
--------------------------------------------------------------------------------------------------------------------------------------------------------------------------------------------------------
--------------------------------------------------------------------------------------------------------------------------------------------------------------------------------------------------------
--------------------------------------------------------------------------------------------------------------------------------------------------------------------------------------------------------
-|X--B-B---B-|----M----o---X-----|M-B--B-?------||-oM-B-B-XM-----o-?||---X-E--MT-B--TXE-o?B|E--|--?---|--|--M---oo-XTE?-X-----X--TTXB--E-T-T--T|?E----BM--M--MTMT-ET----M-----XB|------o--M-B-?--|B-o---
-B-TT-X--BoToBo---o------?--E-To--BB-XX-----EE-o----?TB-EBE|T-T---------ETM-oMB--X--BT--X-B-E|?o??-E-?----M---?--??BX-ooM-E----?--------|-|--oETBEXE-B-?--M---B---E--ToBo|---MTB--|----E-?-o-|M-M-----T-
-B--?---M------|-Bo-T?|E-TE---X--?--B-|||?------E-|-E-TT-XX---T?----M--o--X|M------E--X-?--o-E-EB-XBBo---TBE----B---TX-E--X?M|EM-XT---MoBM----|----M|-XBT?------B-o-T---X-T-B----M--|-E?---?-B?oB------v
--E|BTT--XT|--T-XBoX|-?-o-EX|------?-B--o--X-B-MT|--|B-|MX----T--B-M|--EM--MX--B-T-To--EXB-|--|-o|E-TTE--T--M--X-MMX----B?---o-BTXET---T-B-----EM--M-T-|o--MT?-?-|--|E||??--B?----X|-?B--EXM---XM---BTEf
--M-oMX-T-|oTM-M---T----M--EB----o?---?o-o-T?-|-ooT-----X--?B-----X-----T--------T-E|--T?B--?T-TMX--?-XT---T---TX-X--X---|---o---|T------X--T-|-M-T--B-T---ME-|?M---E---XE-M-TMTB---o-----M-----B-X--?-f
-|-|B-|-T-M--?M-T-ooooo-|TB-?X------EE-?-----X-MT?|-o|-o----Eo-MMX-M--?B---X-o--oB-TBBM--TM-??-|?------X---M-B---XE-------M-MTo-?B-o--?E??EX-E-----T--|EM---EX-----o|------|-EoT|-o?--E?-----BoB------Mf
-E|-T-----MoX---?---B-----|-MMooXX--MBE------oEXEX---|-B---TM------o-X-?--o-B-oBBE?---EM-B----B-|BX--M-o?-B--|M?--TE------||T-o---|-X-----EB?--o?-|--?-|Mo-o---B-E-M-E-M---o-X-M?-|---o-T-M-?EToXTB---?f
-?-----XB---X-BM-|--X-XB?E?----|---BX-EXB-X-E-T--T---?E--E-X--MMEB---o--M------|-M-M-M-|-B?|-MM-?-EMX--?---E?-X---Eo----E---?X--BB---T-?TBB------?--M---EX--X-TB?EE--XM-----|----B-MX-M-M--M---X?---EMof
-----oXEEM??--XB---ME?TTo-XX--TX--o-X|-E--|-o--------T---?--EE---ET-----|-X---?|--?-|B------B----?-MX-E--|M-------E--?---T-|--Mo--EM|B|?-|-E-XoT|-ET-M||-TBoTMXT-oMX-|---MX--|--X-XT|--E--M-EE--XM-M--Ef
m--T--MT-|--T-TT----MoE|-EX-B?--|EX-E--?XX---?-X?-T|---M--------o---|-E---BBM|-|--BE-T-|---o---?E-|---X---|--T--EoM----E?EM-M-X-------B--EEB-E-----Eo|------?-B--?--X--B-XX-B-B---?E||XB-EX???-ToX-----X
XXXXXXXXXXXXXXXXXXXXXXXXXXXXXXXXXXXXXXXXXXXXXXXXXXXXXXXXXXXXXXXXXXXXXXXXXXXXXXXXXXXXXXXXXXXXXXXXXXXXXXXXXXXXXXXXXXXXXXXXXXXXXXXXXXXXXXXXXXXXXXXXXXXXXXXXXXXXXXXXXXXXXXXXXXXXXXXXXXXXXXXXXXXXXXXXXXXXXXXX
