o------------------------------------------------------------------------------------------------------------------------------------------------------------------------------------------------------M
------------------------------o----------------------------------X-------------------------------------------------------------------------------------------------------------------------------------o
T-----------------------------X---------------------------------------------------------------------------------------------------------------------X--------------------------------------------------T
M------------------------------------------------------------------------------------------------------------X-----------------------------------------------------------------------------------------B
?------------------------------------------------------------------------------------------------------------------------------------X------------------------------------------------------------------
Eo-o-|-?-MEoTE---oo--B-?-T--B-Moo-XB-BMM-o--BM-XBBX-?X?o-BBB-oT-M-MM-?--EX?---M--XooE-----oMEo-T---BEBBoo-?X??EX-EXoXXEoMooBEoB?---MB--M--M?-XMoB--o--M?XB?T-o-ooEE?-X---?X-X--??-X-oEo-BBE-E----E?B-XM?
M--XMXoX?--X|oE?-XMM--?ME-M?-?oX?-M--?M?oX-EB-MMX-XBE-BoX?--MMXM--E--?MTXMEo?--E?-XXEMo-XBo-XMXXE--oB?|--X--?T?--X?oBBBX---BoEBB-ooEo?-E?o-B?M-B-?Xo---B?---B??Xoo-MXoo-?MT-XMoMooEX-E-EoTM-?TMBXE--?--|
Xoo-B?BXX?X-X-E-o-?o----oBB-?-BoX?-MXEEoMB--E-EX-XEM-EoX-MX?-oo?-oXEXX-XMXXXo?--oX-Xo?BoE-oB-E?BoXBXBo|XX--?--Eo?-BX-?-EEXM----???TX--BE-?oEB-XXBEM-oB-X-MEB-EXBM--T--o-o--XoB--?X---oEBBXXX--B--T-EXTBv
BB-X?X?BXEXBBB-XBEB-X-BoXB---EX?M--BM-MXE-B-E-oMXX-M?E--o--o?X-E-MTB-B-M?-MXXE?-X-X-?-?oBBXMMMME-M-?-oX--?oEXB-B---oXB??BX-MXXoBX?--??MEBE-XT-M-BE?-E--M--MBoEEXE-E-oM?-??EXB-oMEEX?---XX?M-E-?oX-EX--Bo
?EM--XM--oooB-X--Eo-EBTB??BX-oEM-o-TXXM-o-M-?-o-oEX--?--XoB??-?-oE-EX-X?BXB?MM?B-BoXB-MTo?-M---B-ooXX--XEEEo-??EXM-X?-EBXM-oB-M-MXE-MoX--E-TXBoXBMMX--X-?---MX-M-X--M--M-MMM-oXoB-?X-B-XoEEEo--TX-B--o?T
--?oBT-?XMoXo??oBE-ooEX-XB--BXoo-B-X--oB--o-EBM?X?X-Eo--?---M-MXXX-EoE-M?-ET?oMT?o-XM?-X-XXX--E-o?-?--oE-MX---XXM??EoEE--E?---B-XB?E-B--MMM-oBoo??-?XME-E--X--?MBBXMT-EoT--XBXEB?oT?XMoEoM-Bo--|ooXXToE-
oEBBoX-oo-o|X-EXoMXMXo-Eo---?-BE?XXM?MM-ooXEToE-B-EXMMoTB-Boo?-o-M--Xo--?Eo|?BXX-MMEE-o-XBo---MX?X??XM-MX-oXMX-?--X-E-o?MTooB-B?XMXXXBXX-Mo--oooBM-XB--?E-??-M-E?-M?X-o?---B-MB--o-ME--EXBE-BEMX?X-B-E?o
TX-?MoX-XMBX?-ME?-MM?oE--B---X-B-XEXXE?EXM-?X?--TT---B?XM?oX----EEM---X?-MBXMXBoEBE??o-oM--XBX?o-?-XEX--XXMoM--o-oB-BEBX?XEXooMEXoB--EX-?M-E?-MX?TBB---?XXM-XM--E-oMBM-XXBX-oMMXTMME-XX--B-EXX?M-BoX--?|
ooXT-T?----?T----o-B-XETEB?-X?X?X--X?EB------o-?-|XB--B--EoX-X-----BBB-oE--o----B?T-?-BX?Xo?To??B-?T-B-?XBTo-E---oBXoo-oEX--o-EEX--?--E----B--o-X--X----BBoEB-XBX-oB--BE---?E---X--X--?-T--oE---E?--o--|
mEB|T|--XB?E|BTX-XXo?oE|T---oETBoT--To-E-X|X?o-E?X-To-?---oo?E?-Eo|T-To??o?o?BXXXE|--?X---XoXo---EEX-o-?o-|-TTo----Bo-XX-?TBToBBBE-?X??-XXo-XXo-oBE-X-?XoBB?o-X-BEoEX-?BX?oBXB-X----oT-oXX----ETE?-E-XTo
XXXXXXXXXXXXXXXXXXXXXXXXXXXXXXXXXXXXXXXXXXXXXXXXXXXXXXXXXXXXXXXXXXXXXXXXXXXXXXXXXXXXXXXXXXXXXXXXXXXXXXXXXXXXXXXXXXXXXXXXXXXXXXXXXXXXXXXXXXXXXXXXXXXXXXXXXXXXXXXXXXXXXXXXXXXXXXXXXXXXXXXXXXXXXXXXXXXXXXXX
