-------------------------------------------------------------------------------------------------------------------------------------------------------------------------------------------------------X
o-------------------------------------------------------------------------------------------------------------------------------------------------------------------------------------------------------
M-------------------------------------------------------------------------------------------------------------------------------------------------------------------------------------------------------
B------------------------------------------------------------------------------------------------------------------------------------------------------------------------------------------------------T
E------------------------------------------------------------------------------------------------------------------------------------------------------------------------------------------------------T
Mo--oE----XX---EoE-----X-----XEE--o--E-EXX-Xo--------o----o----XX---X-XX-------Xo-----T--E--oo-------X---------oXXo---------o-o--oo-------XX-EXX----E-o--oXXo---E--E------Xo-X--o-o-XXXE-o-XX--o------Eo
T-o---E---Xo------XE-----oE--------o----oE-----oE---X--o-oE-X--o----X-oE-E--X-X-----E-XXE---o----E-oXo--XE--oXX-----ooo--XE-X----X-o--E--X------o-------X----X------E--E--E-XE-------XE-E--o-o---XE-E-XB
X--o-E--EX---o--oXX----Eo--E------oE---E-E---o-EooE-X-X--oo-o-X-E-Eo--X---------o-X----o--o-E--o----XE--Eo-E-o--oX--EEo---o-----X--X--oo-o-----E---E------E--X-XE-------XX--o----Xo--------Eo-o-E-----ov
T-o-E-o-o-oXX-oo---oXoX-X-----XoXX-o--E----o-E---o--Xo---EoE-E--o------o-o--oX----E-oE-E-----E-----------XEo-X-oEEoEX--Eo--E--o--o-o-oo-XX--X-o-X-o-X---o-X--o-Eoo---E-EX--o-EEE---X---------------X---|
?------o---o---------XX-E-EoEEEX---E----oX-E-E-X--o--o--X----XoE----E----X--X--E-E--o-XE-EX-Xo---EE-X-o-------------E--o--oX-------EX---E---EEE-X-XEX----X-o-E-E-----------Xo--E-o-E-X--o--EEX-------XoM
|-----EoE-E------E-E-------o-o-----X--o--XoX-o---X----E-oo--oX-Eo---E---X---o-X-X-----X-XX---X-X------X-X----XoE--------X--E------o-Eo-X--o-E---Eo------oE--XE-E---------o----oE------o----X---EE---E-E?
?Xo-X-X--Eo----X---o-X--o---X------------X----oE--oE-----X--X---XXXE---oEE-o-----XE---EX-E----E---X--E-XE-o-oE-o-E---X-E-oo-----o-o-------------X-----o---o-X--oo-o----oo--EoEXo--XX-o----Xo--oE-oEoE-X-
|--oE---ETo--o-oo--X-EX--o-o--ooo---E-----------o--oT-oEo-|X-X----E-E-o---ooEoE-----X---o------o---o--ooo---oXEo--X--Xo---o--o-------o---o-----o-----o-X--o-----X-X-o--o--X---X---o-X-E-oo--------------
To-------|---o--E-E-oo-To----oX-E-----EE--X--T----E-|T--o-X---E---XX-------XX-X-ooo----X-XooE-E--E----Eo-oo---o-----X--oo--X----E----o--E--o---X-----XXo------T-Eo---Eo--E----Eo-o--o--XE---------o---oo
m------E-X--XXo---EX--X|E---X-X----o-----o--o|---o--X|-E---EE--oo-o--oo-o------o-oE---X--o-o----E------EX--E---E--Xo-Xoo----oX---X-o-oo-X--oo-o--oE---E--E--Eo|o---X-o-X-o-EX----oE-Eoo--o--Eo-E--E--EET
XXXXXXXXXXXXXXXXXXXXXXXXXXXXXXXXXXXXXXXXXXXXXXXXXXXXXXXXXXXXXXXXXXXXXXXXXXXXXXXXXXXXXXXXXXXXXXXXXXXXXXXXXXXXXXXXXXXXXXXXXXXXXXXXXXXXXXXXXXXXXXXXXXXXXXXXXXXXXXXXXXXXXXXXXXXXXXXXXXXXXXXXXXXXXXXXXXXXXXXX
