--------------------------------------------------------------------------------------------------------------------------------------------------------------------------------------------------------
-------------------------------------------------------------------------------------------------------o------------------------------------------------------------------X-----------------------------
--------------------------------------------------------------------------------------------------------------------------------------------------------------------------------------------------------
-------------------------------------------------------------------------------------------------------------------M-----------------------------------------------------------------o------------------
------------------------------------X-------------------------------------------------------------------------------------------------------------------------------------------------------------------
--M-??-X--XX?-BMMM-??---?--M--o-Mo?-M--B?-B---?B?-o--MBB--MX?-BXB--X----B--X-?X---B-XBXM--X----MXMMX-BX-MB----B-?-X-M-o???M---B--XBM-XMB-M?B-oB--B-?M-?----M--?-XM---?B--Xo---B---?o?---XB-BB---X---?-M-
--o-----M?B-o---o----?B-o---MM?B-X---MM--M-XB----BBB----M?-B---?--MBoXX--?B-B--o-B-X?-?-XMB-X----o--M-M-o---MX--o----BXo--o--B-X--ooM-o----o----?---o---Bo--X--o--B--o-B-o?---o---oM---?B--ooX?------?--
-?MX-M--o-o-??--?--?oo---M?-o--o?--M--o---??-----------?-oM---------B?--M--B---B--M--M--?oo?oM?-M-B------X-M----?MMo?--M-------MX-----M--------M-XB--B??----MM--M-oX?X---B------X-B---?---?----MMBBo---v
-o?X-oB?--Xo-o-?--MoM?-BBo-MX----X--?B--XM--BBM?-?-M--Bo--oX--Mo----?-??------?oXM--M--M----X-o--?--oX?-X?-----?oo-X--X--X---XB--------B?B-BX?X--o-B----------?XoXX---X----o?------B-E-M---BB------X---f
-XoMB---Xo-XB--o-------o----?oX------oXB--o---o--o--X-o---Mo-M---X-M-?-o---B??-o---X----o-M---B-Mo-M--ooM------o--X?M-?o-??--X-X---?------Mo-oB-M?--oB--X---o-----?XXXB-Mo-X-B-?---oM?B-MB------o--X-X?f
--B-o---X------XM-?---M-X--?-BXB-?---XB-o?o---MX--------M----o----X---?--M--------XX---o?---oMo--X---??M----MX-?B?----o?o----?XM-?MoT---X---M--Xo-----Bo-oBM?XXX-?-B-B-X--??-o--B-B-o-o-o-----M-B--X---f
-------X--oX-B?-o---B--XXM----B-X--?Mo-XB--??B-X??M-M----XB-B-----X-MM-M?--M?-?---X---?M--??----o-X-X---?----?o--o-Mo---XM-MB-?-----|X--?--?o-MBXMBX-B--X-o----B-----o--M-o-XBB-XMo???B?--B?-?--o?-X--Xf
-BoXo--X--X-B--BM?BBo--??-M--B--?B---BM---o------oo---EX-----------------M---Mo-B--?-M----o--?M-M---M-----?M-o-M--EoX--o?------M----XM-B-X--X-------?---o-?-X-B-o?--X--?--?M?-o-----------o-M--B--??BB-f
---X---------o-o--o--------o------X---o--E-X---------oMo-X-T--------------XX----------o-----o-o-------o----oo-----o---Xoo-----------T------X-------X--------o-o-X---------o--X---o-?o-o-o---o--------o-f
m---X-----o--oX---T---------------------MB----X-X--Xo-----X|X--Xo---------X--X--M--X----o-X--------XXXoo------Xo-------XX-----X--XXX|-----oo-XXX----X----------------X-X---------o--oo---X-o-----X-----X
X-XXX-XX-XXX--XXXXX-XXXX--XXXX-X--XXXXXXX--XXXX-X-X-X-XXX-XXXXX-X-XXXXXX-XX--XXXX-XXXXXXXXXX-XXXXXXX-XX--XXX--X--X-X-XXX-XXX-XXX-X--X--X-XXXXX--XX-XXXX-X--XXXXXX-XX-XXXXXXX--XX-X-XX-XXXX-MX-XXX-X--XXX
