o-------------------------------------------------------------------------------------------------------------------------------------------------------------------------------------------------------
?------------------------------------------------------------------------------------------------------------------------------------------------------------------------------------------------------|
|------------------------------------------------------------------------------------------------------------------------------------------------------------------------------------------------------T
?------------------------------------------------------------------------------------------------------------------------------------------------------------------------------------------------------|
X------------------------------------------------------------------------------------------------------------------------------------------------------------------------------------------------------o
E-o?-?B--Bo?-X--X?--E-?BBoB-M--M-------?-B?--?o--BoMo?Boo?B-o-BB?M-BMX--ooMEBo?-o--M-M--MB-X?oBMMoMoMoBo-?o-XMo-o-?-EoBoMMEX-?BMM?Mo?-oXo-MX-MBB-X-M?oX?M-BB?-?-X--o-oMX-o---oBBo-EMXB-oM---oBo----o-BB?
??o--o--o------o----X-----o--o?o-oBo?---o-oo----X-?-?ooX---?o----o-o-Bo-XooXo--MBB-o?oooo-oXo?---M-X-o-Bo-B??-o-ME-M?-o---?-o-----oB-X?BB--o---oB-oo-MM------o-o--oX-M-MoB?-oM--XoX-X-----X?--B-MM-?---T
?--MXoo-MB---Mooo--oXB?o-XMM-B---X-?-M--M-o?---?oX-B--Bo--o----o-MM---M?oB-o-o--o-?BB?Bo---?--B-o-o--ME-?-----M-?XMo--M--M--X?-?--Xo-----?-BB---oMo-o---T--o?-o-X-Xo---oM---M--?X--oEX?o--B--oo-o-X-BX?v
XM?-Mo-?-o--?oXo---XB--ooM--M-o--BB---B-oo--o----X--?--B-?--oo-Mo-o-?-o-o-X?BMM-o----|o?-?B-oM-B-oXoo-Boo-X----oo--oX-oMM-XM-----oooo-----?---oo---MMBBB|MMM-o--B-M?---?oX-o--M-?-MBMM--X--oBBXM--M----T
B--o-?M--o---oBMooo--MM-X-------oo--BXo-?MooX-X?-MoB-?o-o-oXMBB-B-oM------?o----TE--oX?-?--oo-o-o??M-oMXXE-----X-o?---?--M--B-XooMX-?o|BX?oo--?MXE?----oX-BX?M-X-X----B-E?-oMo-----M-oo-o?oB--?-XBoo-o?-
?-BB---oM?BoBM---oMo-o-EoooX----XMo--o-o---?--o-BoMo-o-?--?o--oB-----o--o-oo-o--|M?oMB------X---B---?M--oBB-E?E?-B-o---?o-M-o-BMX-M?-BXoo-XoBo---B---M----B|o-oX--oM---E?--?-oXoo?B-B?MMooB-X---B--o-M-|
|B---ooM-o----oXoB-BBB?MXX-X-?---oXM-o-o?Bo-BEM----BB?-oo?----o---BBoM---XB?-B--XX-M-o-X--oo-M-Bo--o---?XMo-XoB-o--B|oooXoo-oo----o-?-o--X?o-Bo-E-X---X-XE-XXB--X-?-?B-ME|--oB??--?-----B-o-B-o---M?-ooM
---Xo-M--BoMo-?o--M---BB--?-Xo--o-?--B-X-----X--B??-----?-o-?-E--B--M--oXo--?--o-MM-X--?-??o-----o-XB----ooX-o??---oX-?oXM--X?B?B?--ooX----X--oB?EBo-XoBXXXM-oBE------X-?--?o-----------oE---oMo-oo-MX-?
---Eo----oXoo---Eo-o-------o-?oo-MXB?o----M?XB-o-o--X----o---XM--o---o---X----oo--o-o---X--XXo-o-o-o-----XTXoo-o-X---ooXo--o---oo--o----o----E-o-?------o---XX-BooXXoooooXooX---o-EX---XM??X-E-oBX?X-ooE
m-?MX-------ooMX??---o-|oXoX-X-oXo---oo-----oo-ooo---o----o-Xo-o-oXoXo-----XX-----oXo--o--ooXXooooX--o-X-X|XX--o-oXoo--Xoo-o??o--oo--o-o--X--M----oXoXo--o-Xo-X-o--oooo-ooX|----oXXo-|-o?oo-oMX-------||
XXXXXXXXXXXXXXXXXXXXXXXXXXXXXXXXXXXXXXXXXXXXXXXXXXXXXXXXXXXXXXXXXXXXXXXXXXXXXXXXXXXXXXXXXXXXXXXXXXXXXXXXXXXXXXXXXXXXXXXXXXXXXXXXXXXXXXXXXXXXXXXXXXXXXXXXXXXXXXXXXXXXXXXXXXXXXXXXXXXXXXXXXXXXXXXXXXXXXXXX
