|------------------------------------------------------------------------------------------------------------------------------------------------------------------------------------------------------E
?------------------------------------------------------------------------------------------------------------------------------------------------------------------------------------------------------o
?------------------------------------------------------------------------------------------------------------------------------------------------------------------------------------------------------B
M------------------------------------------------------------------------------------------------------------------------------------------------------------------------------------------------------E
M------------------------------------------------------------------------------------------------------------------------------------------------------------------------------------------------------B
|o?-?oo-oo--ooBB?-?-oooXMX-EoXM-oXoM?----?-o?o-o-o?B-X-B--BoME?Xo-?-M-BEB---B-Bo-?X-BB-----oooo-?X--B---MB-XoBooE-X--X-Bo-?--Boo--XoooXMB-o-?B-M-B-MMB-X--B-o?o-Bo-X-oo-oo---??-E?-o-??--XMB?MEXE??---oT
T--Mo---XX--??----o?--o?oXBMXoo-XBX-----XoB?oMoX-?--?XM-BMo-XB-?MEoo-B?M-o?o-B-X--XBo-o?--o-MBXX-oo---B----?MooMXo-X-oM-?o-oM-B??XEo---o-BXo--M-M-o-o-X-B--o--o--X-B-?Xooo-BB--??-?oM--oo-o--oBMM-o-ooX?
-o---ME---Mo-----Xo-B-?-??o??oX--oX?Xo---Xo---?oM-BooB-Xo--o?|-X?MMX--oX-o-X--?X-oo-BMXo?XBoo-Xo-?-BEo-E-o---oMM-o???Xoo-X-X----MMMXM--?-------B--Bo-o?o--MooB??-??----?-M-o-o--o--?o--E-??BXXM----X---v
TM??-X?BXo-BM-?----B--oXo-o--MBT?oX--BM-M?o?MM-----MX-M----X-Xo---oM-oB?o-oXoB-oo-?o--XB-X-M-B----M?XBMX-oX|----??----MM?XMoB?-XM--X---BBMB-o-XoM-oo-o-MXBoB----M--Xo-M-X-o-----oX-o-?X?M-oXBB?o--M-?--M
?---B-M-Bo---B-BXM--?--------o-|-Mo?--o--o?--o--M---?-----o--XM-Bo-o---oM-?MM--o-E-?-oX-o-o---oX--BBo--B---X-B-Xo-??-M-BB------X-T?--o---X--Bo---ooXBM-o---------X-M-Mo--ToM-M-oBo-o-o-ooB-?oo-B-----X--
oX--X?--oBoo--o-X-o-oB--?---?--X--o-Mo-oX--oBM--o----X--o-?B-X-o-B----o?-B---B--MMB-M?-BB-?XB-MM----o?o-?-BB----oo-------Bo-?--XM|---Xoo-XX-oX-oo-X?o-Xo-M--X-o--B--M--X-|M-?ooXooooBME--o?o-o---XBMoooX
B?-Mo?-M--BXoB--?---X-oM-M?o--B---M---?BX--M---M-MB??BoBB----?-B----oM?oM-oo---M-?MM--?X-B------?B-oXo?X-o-o-X?--M?-X?----B--??B-X-BoM?MB---BoBoX-E-B-MM-oB-XXo?B-----oXoX-o--BBBXEM--B?----B-o--oo--BXo
X--o----o--?--?-o-EoM-M-Bo--E-oo---o-M---MX-----?o----X-----o-o--?oEB-------M-?-oE-BMM-B---MoE?oo--B?X--?X--oo-?E--o?--Mo------o-M-----o--BB-Xo-BX?--o--MB-ooo?oooXBXBB-?--X-?--MM?o--B-E?oM---?-B--B--T
---oX---o--oo-oM??M---------B-o-XXoo---o-----o---oT---------X-o---XM---X--------XM--------oXXB-X-----X-----o--X??XEXo-o-----o-----Xo----XX-o-XX--X--------|TXX--oE----oXo-Eoo---ooT-X-XB?-------X-o?o-oM
mXooo----oo|o-ooX------o-Xo--|-X------ooo---oX|-o-|oo--ooo-oo---o-ooXo--ooooo--o--X--o--ooo-X--oo-|--oX-o----o-oXBX?-oXo-----o-----X----o-o-oX-o---oX-o-Xo||o--??XXo--oo-??o-|----|-o-Xoo--o---oooMX??-o
XXXXXXXXXXXXXXXXXXXXXXXXXXXXXXXXXXXXXXXXXXXXXXXXXXXXXXXXXXXXXXXXXXXXXXXXXXXXXXXXXXXXXXXXXXXXXXXXXXXXXXXXXXXXXXXXXXXXXXXXXXXXXXXXXXXXXXXXXXXXXXXXXXXXXXXXXXXXXXXXXXXXXXXXXXXXXXXXXXXXXXXXXXXXXXXXXXXXXXXX
